date,total_confirmed,total_deaths,total_recovered,total_infected,mortality_rate,recovery_rate,daily_growth_rate
03-22-2020,1,0,0,1,0.0,0.0,1
03-23-2020,1,0,0,1,0.0,0.0,1.0
03-24-2020,1,0,0,1,0.0,0.0,1.0
03-25-2020,5,0,0,5,0.0,0.0,5.0
03-26-2020,5,0,0,5,0.0,0.0,1.0
03-27-2020,5,0,0,5,0.0,0.0,1.0
03-28-2020,5,0,0,5,0.0,0.0,1.0
03-29-2020,9,1,0,9,11.11,0.0,1.8
03-30-2020,10,2,0,10,20.0,0.0,1.1111111111111112
03-31-2020,10,2,0,10,20.0,0.0,1.0
04-01-2020,10,2,0,10,20.0,0.0,1.0
04-02-2020,16,2,0,16,12.5,0.0,1.6
04-03-2020,16,2,0,16,12.5,0.0,1.0
04-04-2020,16,2,2,14,12.5,12.5,1.0
04-05-2020,19,2,2,17,10.53,10.53,1.1875
04-06-2020,19,2,2,17,10.53,10.53,1.0
04-07-2020,19,2,3,16,10.53,15.79,1.0
04-08-2020,19,2,4,15,10.53,21.05,1.0
04-09-2020,19,2,4,15,10.53,21.05,1.0
04-10-2020,19,2,4,15,10.53,21.05,1.0
04-11-2020,25,2,5,20,8.0,20.0,1.3157894736842106
04-12-2020,25,2,5,20,8.0,20.0,1.0
04-13-2020,25,2,5,20,8.0,20.0,1.0
04-14-2020,29,2,5,24,6.9,17.24,1.16
04-15-2020,33,2,5,28,6.06,15.15,1.1379310344827587
04-16-2020,33,2,5,28,6.06,15.15,1.0
04-17-2020,38,2,5,33,5.26,13.16,1.1515151515151516
04-18-2020,38,2,5,33,5.26,13.16,1.0
04-19-2020,39,3,5,34,7.69,12.82,1.0263157894736843
04-20-2020,39,3,5,34,7.69,12.82,1.0
04-21-2020,42,3,6,36,7.14,14.29,1.0769230769230769
04-22-2020,42,3,6,36,7.14,14.29,1.0
04-23-2020,42,3,6,36,7.14,14.29,1.0
04-24-2020,42,3,6,36,7.14,14.29,1.0
04-25-2020,42,3,11,31,7.14,26.19,1.0
04-26-2020,43,3,14,29,6.98,32.56,1.0238095238095237
04-27-2020,43,3,19,24,6.98,44.19,1.0
04-28-2020,43,3,21,22,6.98,48.84,1.0
04-29-2020,43,3,21,22,6.98,48.84,1.0
04-30-2020,43,3,21,22,6.98,48.84,1.0
05-01-2020,44,3,27,17,6.82,61.36,1.0232558139534884
05-02-2020,44,3,27,17,6.82,61.36,1.0
05-03-2020,44,3,27,17,6.82,61.36,1.0
05-04-2020,44,3,27,17,6.82,61.36,1.0
05-05-2020,44,3,27,17,6.82,61.36,1.0
05-06-2020,45,3,27,18,6.67,60.0,1.0227272727272727
05-07-2020,45,3,27,18,6.67,60.0,1.0
05-08-2020,47,3,29,18,6.38,61.7,1.0444444444444445
05-09-2020,47,3,29,18,6.38,61.7,1.0
05-10-2020,47,3,29,18,6.38,61.7,1.0
05-11-2020,47,3,29,18,6.38,61.7,1.0
05-12-2020,47,3,29,18,6.38,61.7,1.0
05-13-2020,48,3,29,19,6.25,60.42,1.0212765957446808
05-14-2020,48,3,29,19,6.25,60.42,1.0
05-15-2020,50,3,36,14,6.0,72.0,1.0416666666666667
05-16-2020,51,3,36,15,5.88,70.59,1.02
05-17-2020,58,3,36,22,5.17,62.07,1.1372549019607843
05-18-2020,58,3,36,22,5.17,62.07,1.0
05-19-2020,58,3,36,22,5.17,62.07,1.0
05-20-2020,58,3,36,22,5.17,62.07,1.0
05-21-2020,58,3,36,22,5.17,62.07,1.0
05-22-2020,59,4,37,22,6.78,62.71,1.0172413793103448
05-23-2020,70,4,37,33,5.71,52.86,1.1864406779661016
05-24-2020,86,4,41,45,4.65,47.67,1.2285714285714286
05-25-2020,106,4,41,65,3.77,38.68,1.2325581395348837
05-26-2020,121,4,41,80,3.31,33.88,1.1415094339622642
05-27-2020,121,4,43,78,3.31,35.54,1.0
05-28-2020,122,4,43,79,3.28,35.25,1.0082644628099173
05-29-2020,122,4,43,79,3.28,35.25,1.0
05-30-2020,122,4,43,79,3.28,35.25,1.0
05-31-2020,122,5,46,76,4.1,37.7,1.0
06-01-2020,123,5,46,77,4.07,37.4,1.0081967213114753
06-02-2020,123,6,50,73,4.88,40.65,1.0
06-03-2020,123,6,53,70,4.88,43.09,1.0
06-04-2020,124,6,53,71,4.84,42.74,1.008130081300813
06-05-2020,124,6,53,71,4.84,42.74,1.0
06-06-2020,125,6,58,67,4.8,46.4,1.0080645161290323
06-07-2020,141,6,58,83,4.26,41.13,1.1280000000000001
06-08-2020,144,6,62,82,4.17,43.06,1.0212765957446808
06-09-2020,146,6,62,84,4.11,42.47,1.0138888888888888
06-10-2020,152,6,68,84,3.95,44.74,1.0410958904109588
06-11-2020,164,6,68,96,3.66,41.46,1.0789473684210527
06-12-2020,164,6,68,96,3.66,41.46,1.0
06-13-2020,170,6,71,99,3.53,41.76,1.0365853658536586
06-14-2020,177,6,74,103,3.39,41.81,1.0411764705882354
06-15-2020,177,6,78,99,3.39,44.07,1.0
06-16-2020,177,6,78,99,3.39,44.07,1.0
06-17-2020,178,7,78,100,3.93,43.82,1.0056497175141244
06-18-2020,187,7,78,109,3.74,41.71,1.050561797752809
06-19-2020,187,7,78,109,3.74,41.71,1.0
06-20-2020,198,7,83,115,3.54,41.92,1.0588235294117647
06-21-2020,204,7,83,121,3.43,40.69,1.0303030303030303
06-22-2020,219,7,83,136,3.2,37.9,1.0735294117647058
06-23-2020,231,7,94,137,3.03,40.69,1.0547945205479452
06-24-2020,231,7,94,137,3.03,40.69,1.0
06-25-2020,242,7,96,146,2.89,39.67,1.0476190476190477
06-26-2020,255,8,102,153,3.14,40.0,1.0537190082644627
06-27-2020,256,9,102,154,3.52,39.84,1.003921568627451
06-28-2020,256,9,102,154,3.52,39.84,1.0
06-29-2020,269,9,102,167,3.35,37.92,1.05078125
06-30-2020,279,9,105,174,3.23,37.63,1.037174721189591
07-01-2020,293,9,110,183,3.07,37.54,1.050179211469534
07-02-2020,312,9,113,199,2.88,36.22,1.0648464163822526
07-03-2020,328,10,123,205,3.05,37.5,1.0512820512820513
07-04-2020,338,10,123,215,2.96,36.39,1.0304878048780488
07-05-2020,358,13,126,232,3.63,35.2,1.0591715976331362
07-06-2020,372,14,126,246,3.76,33.87,1.0391061452513966
07-07-2020,372,14,126,246,3.76,33.87,1.0
07-08-2020,372,14,126,246,3.76,33.87,1.0
07-09-2020,372,14,126,246,3.76,33.87,1.0
07-10-2020,394,16,126,268,4.06,31.98,1.0591397849462365
07-11-2020,394,16,126,268,4.06,31.98,1.0
07-12-2020,394,16,126,268,4.06,31.98,1.0
07-13-2020,417,19,136,281,4.56,32.61,1.0583756345177664
07-14-2020,439,21,138,301,4.78,31.44,1.052757793764988
07-15-2020,458,22,140,318,4.8,30.57,1.0432801822323463
07-16-2020,477,22,140,337,4.61,29.35,1.0414847161572052
07-17-2020,496,25,144,352,5.04,29.03,1.039832285115304
07-18-2020,496,25,144,352,5.04,29.03,1.0
07-19-2020,496,25,144,352,5.04,29.03,1.0
07-20-2020,522,29,154,368,5.56,29.5,1.0524193548387097
07-21-2020,540,31,160,380,5.74,29.63,1.0344827586206897
07-22-2020,561,32,165,396,5.7,29.41,1.038888888888889
07-23-2020,584,35,174,410,5.99,29.79,1.0409982174688057
07-24-2020,608,35,184,424,5.76,30.26,1.0410958904109588
07-25-2020,627,36,191,436,5.74,30.46,1.03125
07-26-2020,650,38,200,450,5.85,30.77,1.036682615629984
07-27-2020,674,40,210,464,5.93,31.16,1.0369230769230768
07-28-2020,694,40,220,474,5.76,31.7,1.029673590504451
07-29-2020,717,40,229,488,5.58,31.94,1.0331412103746398
07-30-2020,738,41,229,509,5.56,31.03,1.0292887029288702
07-31-2020,757,43,237,520,5.68,31.31,1.0257452574525745
08-01-2020,780,43,237,543,5.51,30.38,1.0303830911492735
08-02-2020,809,44,256,553,5.44,31.64,1.0371794871794873
08-03-2020,847,46,268,579,5.43,31.64,1.0469715698393078
08-04-2020,892,46,283,609,5.16,31.73,1.053128689492326
08-05-2020,944,48,296,648,5.08,31.36,1.0582959641255605
08-06-2020,999,48,311,688,4.8,31.13,1.0582627118644068
08-07-2020,1060,48,311,749,4.53,29.34,1.0610610610610611
08-08-2020,1125,50,331,794,4.44,29.42,1.0613207547169812
08-09-2020,1188,52,346,842,4.38,29.12,1.056
08-10-2020,1255,52,364,891,4.14,29.0,1.0563973063973064
08-11-2020,1327,53,385,942,3.99,29.01,1.0573705179282868
08-12-2020,1327,53,385,942,3.99,29.01,1.0
08-13-2020,1432,55,395,1037,3.84,27.58,1.0791258477769405
08-14-2020,1515,58,403,1112,3.83,26.6,1.0579608938547487
08-15-2020,1593,60,408,1185,3.77,25.61,1.0514851485148515
08-16-2020,1677,64,417,1260,3.82,24.87,1.0527306967984935
08-17-2020,1764,68,425,1339,3.85,24.09,1.0518783542039356
08-18-2020,1844,73,425,1419,3.96,23.05,1.0453514739229024
08-19-2020,1927,78,445,1482,4.05,23.09,1.045010845986985
08-20-2020,2008,82,460,1548,4.08,22.91,1.0420342501297353
08-21-2020,2073,83,475,1598,4.0,22.91,1.032370517928287
08-22-2020,2143,85,490,1653,3.97,22.87,1.0337674867342017
08-23-2020,2217,89,505,1712,4.01,22.78,1.0345310312645823
08-24-2020,2293,92,519,1774,4.01,22.63,1.034280559314389
08-25-2020,2365,95,533,1832,4.02,22.54,1.03139991277802
08-26-2020,2440,98,550,1890,4.02,22.54,1.0317124735729386
08-27-2020,2504,100,569,1935,3.99,22.72,1.0262295081967212
08-28-2020,2563,103,584,1979,4.02,22.79,1.023562300319489
08-29-2020,2628,106,599,2029,4.03,22.79,1.0253609051892314
08-30-2020,2703,109,614,2089,4.03,22.72,1.028538812785388
08-31-2020,2765,112,629,2136,4.05,22.75,1.0229374768775434
09-01-2020,2830,116,646,2184,4.1,22.83,1.0235081374321882
09-02-2020,2898,120,661,2237,4.14,22.81,1.0240282685512367
09-03-2020,2973,124,681,2292,4.17,22.91,1.025879917184265
09-04-2020,3041,127,698,2343,4.18,22.95,1.0228725193407333
09-05-2020,3104,130,715,2389,4.19,23.03,1.0207168694508386
09-06-2020,3171,134,730,2441,4.23,23.02,1.0215850515463918
09-07-2020,3229,137,744,2485,4.24,23.04,1.0182907600126143
09-08-2020,3289,140,760,2529,4.26,23.11,1.0185816042118303
09-09-2020,3351,143,780,2571,4.27,23.28,1.0188507145028884
09-10-2020,3416,147,797,2619,4.3,23.33,1.0193971948672038
09-11-2020,3476,150,812,2664,4.32,23.36,1.0175644028103044
09-12-2020,3506,152,827,2679,4.34,23.59,1.0086306098964326
09-13-2020,3540,155,842,2698,4.38,23.79,1.0096976611523103
09-14-2020,3576,157,858,2718,4.39,23.99,1.0101694915254238
09-15-2020,3614,160,871,2743,4.43,24.1,1.0106263982102908
09-16-2020,3654,163,889,2765,4.46,24.33,1.0110680686220255
09-17-2020,3691,165,903,2788,4.47,24.46,1.0101258894362342
09-18-2020,3731,168,918,2813,4.5,24.6,1.010837171498239
09-19-2020,3765,170,932,2833,4.52,24.75,1.009112838381131
09-20-2020,3800,172,946,2854,4.53,24.89,1.0092961487383798
09-21-2020,3833,175,963,2870,4.57,25.12,1.0086842105263158
09-22-2020,3877,178,983,2894,4.59,25.35,1.0114792590660058
09-23-2020,3924,181,998,2926,4.61,25.43,1.012122775341759
09-24-2020,3966,183,1013,2953,4.61,25.54,1.010703363914373
09-25-2020,4001,185,1028,2973,4.62,25.69,1.008825012607161
09-26-2020,4038,188,1048,2990,4.66,25.95,1.0092476880779806
09-27-2020,4072,192,1062,3010,4.72,26.08,1.008420009905894
09-28-2020,4102,194,1074,3028,4.73,26.18,1.0073673870333988
09-29-2020,4148,197,1088,3060,4.75,26.23,1.0112140419307656
09-30-2020,4200,200,1103,3097,4.76,26.26,1.012536162005786
10-01-2020,4247,202,1117,3130,4.76,26.3,1.0111904761904762
10-02-2020,4289,203,1130,3159,4.73,26.35,1.0098893336472805
10-03-2020,4329,204,1143,3186,4.71,26.4,1.009326183259501
10-04-2020,4366,205,1155,3211,4.7,26.45,1.0085470085470085
10-05-2020,4411,207,1168,3243,4.69,26.48,1.0103069170865782
10-06-2020,4457,209,1183,3274,4.69,26.54,1.0104284742688732
10-07-2020,4504,212,1198,3306,4.71,26.6,1.0105452097823648
10-08-2020,4566,215,1212,3354,4.71,26.54,1.013765541740675
10-09-2020,4616,218,1235,3381,4.72,26.75,1.0109505037231712
10-10-2020,4673,221,1271,3402,4.73,27.2,1.0123483535528597
10-11-2020,4718,224,1296,3422,4.75,27.47,1.0096297881446608
10-12-2020,4774,228,1331,3443,4.78,27.88,1.0118694362017804
10-13-2020,4826,231,1364,3462,4.79,28.26,1.0108923334729787
10-14-2020,4883,234,1389,3494,4.79,28.45,1.0118110236220472
10-15-2020,4931,238,1425,3506,4.83,28.9,1.009830022527135
10-16-2020,4987,241,1456,3531,4.83,29.2,1.0113567227742852
10-17-2020,5033,245,1494,3539,4.87,29.68,1.0092239823541207
10-18-2020,5077,248,1528,3549,4.88,30.1,1.0087423008146235
10-19-2020,5134,251,1565,3569,4.89,30.48,1.0112271026196573
10-20-2020,5180,254,1596,3584,4.9,30.81,1.0089598753408648
10-21-2020,5224,257,1629,3595,4.92,31.18,1.0084942084942086
10-22-2020,5267,260,1655,3612,4.94,31.42,1.00823124042879
10-23-2020,5319,264,1692,3627,4.96,31.81,1.0098727928612112
10-24-2020,5359,267,1722,3637,4.98,32.13,1.0075202105658958
10-25-2020,5408,269,1753,3655,4.97,32.41,1.0091434969210673
10-26-2020,5461,272,1788,3673,4.98,32.74,1.0098002958579881
10-27-2020,5528,275,1821,3707,4.97,32.94,1.012268815235305
10-28-2020,5580,278,1861,3719,4.98,33.35,1.0094066570188134
10-29-2020,5633,281,1898,3735,4.99,33.69,1.0094982078853048
10-30-2020,5683,285,1937,3746,5.01,34.08,1.0088762648677436
10-31-2020,5728,288,1976,3752,5.03,34.5,1.0079183529825797
11-01-2020,5789,292,2021,3768,5.04,34.91,1.010649441340782
11-02-2020,5843,295,2061,3782,5.05,35.27,1.0093280359302124
11-03-2020,5888,298,2100,3788,5.06,35.67,1.007701523190142
11-04-2020,5964,301,2143,3821,5.05,35.93,1.012907608695652
11-05-2020,6040,305,2195,3845,5.05,36.34,1.0127431254191817
11-06-2020,6102,309,2254,3848,5.06,36.94,1.0102649006622517
11-07-2020,6147,313,2302,3845,5.09,37.45,1.0073746312684366
11-08-2020,6215,317,2357,3858,5.1,37.92,1.0110623068163331
11-09-2020,6284,321,2405,3879,5.11,38.27,1.0111021721641191
11-10-2020,6352,325,2454,3898,5.12,38.63,1.0108211330362826
11-11-2020,6421,329,2504,3917,5.12,39.0,1.0108627204030227
11-12-2020,6486,333,2558,3928,5.13,39.44,1.010123033795359
11-13-2020,6552,337,2609,3943,5.14,39.82,1.0101757631822386
11-14-2020,6613,341,2665,3948,5.16,40.3,1.0093101343101343
11-15-2020,6684,345,2714,3970,5.16,40.6,1.0107364282473914
11-16-2020,6759,350,2759,4000,5.18,40.82,1.0112208258527828
11-17-2020,6836,354,2817,4019,5.18,41.21,1.0113922177836958
11-18-2020,6919,358,2868,4051,5.17,41.45,1.01214160327677
11-19-2020,6991,363,2924,4067,5.19,41.83,1.0104061280531869
11-20-2020,7079,368,2986,4093,5.2,42.18,1.012587612644829
11-21-2020,7154,372,3043,4111,5.2,42.54,1.010594716767905
11-22-2020,7225,376,3097,4128,5.2,42.87,1.0099245177523064
11-23-2020,7295,380,3155,4140,5.21,43.25,1.0096885813148788
11-24-2020,7369,385,3213,4156,5.22,43.6,1.010143934201508
11-25-2020,7459,391,3271,4188,5.24,43.85,1.0122133260958068
11-26-2020,7542,399,3330,4212,5.29,44.15,1.0111274969835098
11-27-2020,7635,404,3389,4246,5.29,44.39,1.0123309466984884
11-28-2020,7715,409,3444,4271,5.3,44.64,1.0104780615586118
11-29-2020,7797,413,3500,4297,5.3,44.89,1.0106286454957873
11-30-2020,7887,417,3560,4327,5.29,45.14,1.0115429011158137
12-01-2020,7973,422,3624,4349,5.29,45.45,1.01090401927222
12-02-2020,8059,426,3689,4370,5.29,45.77,1.0107864041138843
12-03-2020,8147,432,3748,4399,5.3,46.0,1.0109194689167391
12-04-2020,8233,437,3811,4422,5.31,46.29,1.0105560328955443
12-05-2020,8320,442,3879,4441,5.31,46.62,1.0105672294424874
12-06-2020,8403,447,3943,4460,5.32,46.92,1.0099759615384616
12-07-2020,8490,452,4000,4490,5.32,47.11,1.0103534451981435
12-08-2020,8580,458,4059,4521,5.34,47.31,1.010600706713781
12-09-2020,8675,465,4114,4561,5.36,47.42,1.0110722610722611
12-10-2020,8787,476,4174,4613,5.42,47.5,1.0129106628242075
12-11-2020,8911,491,4243,4668,5.51,47.62,1.0141117560031865
12-12-2020,9041,506,4319,4722,5.6,47.77,1.0145887105824263
12-13-2020,9166,518,4376,4790,5.65,47.74,1.0138259042141355
12-14-2020,9302,530,4432,4870,5.7,47.65,1.014837442723107
12-15-2020,9452,543,4494,4958,5.74,47.55,1.0161255643947538
12-16-2020,9603,554,4548,5055,5.77,47.36,1.0159754549301736
12-17-2020,9759,571,4616,5143,5.85,47.3,1.0162449234614184
12-18-2020,9928,591,4686,5242,5.95,47.2,1.0173173480889435
12-19-2020,10050,601,4737,5313,5.98,47.13,1.0122884770346494
12-20-2020,10195,610,4786,5409,5.98,46.94,1.0144278606965174
12-21-2020,10318,621,4835,5483,6.02,46.86,1.0120647376164786
12-22-2020,10442,630,4885,5557,6.03,46.78,1.0120178329133553
12-23-2020,10571,641,4927,5644,6.06,46.61,1.012353955181
12-24-2020,10701,652,4997,5704,6.09,46.7,1.0122977958565889
12-25-2020,10821,660,5048,5773,6.1,46.65,1.0112139052425007
12-26-2020,10932,669,5093,5839,6.12,46.59,1.0102578319933462
12-27-2020,11033,678,5141,5892,6.15,46.6,1.0092389315770216
12-28-2020,11138,686,5192,5946,6.16,46.62,1.0095169038339527
12-29-2020,11243,696,5248,5995,6.19,46.68,1.0094271862093733
12-30-2020,11344,704,5296,6048,6.21,46.69,1.0089833674286222
12-31-2020,11434,711,5350,6084,6.22,46.79,1.0079337094499294
01-01-2021,11526,717,5420,6106,6.22,47.02,1.0080461780654189
01-02-2021,11616,723,5485,6131,6.22,47.22,1.0078084331077564
01-03-2021,11710,729,5546,6164,6.23,47.36,1.0080922865013775
01-04-2021,11799,734,5615,6184,6.22,47.59,1.007600341588386
01-05-2021,11890,741,5686,6204,6.23,47.82,1.0077125180100008
01-06-2021,11988,747,5753,6235,6.23,47.99,1.008242220353238
01-07-2021,12084,755,5824,6260,6.25,48.2,1.008008008008008
01-08-2021,12179,763,5889,6290,6.26,48.35,1.0078616352201257
01-09-2021,12274,768,5953,6321,6.26,48.5,1.0078003120124805
01-10-2021,12364,774,6029,6335,6.26,48.76,1.007332572918364
01-11-2021,12462,781,6098,6364,6.27,48.93,1.007926237463604
01-12-2021,12558,790,6185,6373,6.29,49.25,1.0077034183919114
01-13-2021,12660,799,6259,6401,6.31,49.44,1.0081223124701386
01-14-2021,12760,809,6329,6431,6.34,49.6,1.0078988941548184
01-15-2021,12850,817,6405,6445,6.36,49.84,1.0070532915360502
01-16-2021,12942,824,6474,6468,6.37,50.02,1.00715953307393
01-17-2021,13036,832,6548,6488,6.38,50.23,1.0072631741616442
01-18-2021,13132,841,6624,6508,6.4,50.44,1.0073642221540349
01-19-2021,13224,850,6696,6528,6.43,50.64,1.0070057873895828
01-20-2021,13313,858,6773,6540,6.44,50.88,1.00673018753781
01-21-2021,13398,866,6842,6556,6.46,51.07,1.0063847367235033
01-22-2021,13479,873,6918,6561,6.48,51.32,1.0060456784594716
01-23-2021,13557,879,6989,6568,6.48,51.55,1.0057867794346762
01-24-2021,13628,885,7056,6572,6.49,51.78,1.0052371468614
01-25-2021,13697,890,7121,6576,6.5,51.99,1.0050631053712944
01-26-2021,13762,895,7185,6577,6.5,52.21,1.004745564722202
01-27-2021,13823,900,7260,6563,6.51,52.52,1.0044324952768493
01-28-2021,13885,906,7329,6556,6.53,52.78,1.004485278159589
01-29-2021,13944,911,7406,6538,6.53,53.11,1.0042491897731365
01-30-2021,13998,916,7481,6517,6.54,53.44,1.0038726333907058
01-31-2021,14048,921,7562,6486,6.56,53.83,1.003571938848407
02-01-2021,14096,926,7644,6452,6.57,54.23,1.0034168564920274
02-02-2021,14142,929,7725,6417,6.57,54.62,1.0032633371169126
02-03-2021,14202,933,7807,6395,6.57,54.97,1.0042426813746288
02-04-2021,14267,938,7892,6375,6.57,55.32,1.0045768201661738
02-05-2021,14338,943,7974,6364,6.58,55.61,1.0049765192402047
02-06-2021,14408,947,8053,6355,6.57,55.89,1.0048821313990794
02-07-2021,14477,952,8134,6343,6.58,56.19,1.004789006107718
02-08-2021,14551,958,8213,6338,6.58,56.44,1.0051115562616564
02-09-2021,14611,961,8288,6323,6.58,56.72,1.0041234279430966
02-10-2021,14668,965,8366,6302,6.58,57.04,1.0039011703511054
02-11-2021,14724,968,8438,6286,6.57,57.31,1.0038178347422961
02-12-2021,14765,971,8520,6245,6.58,57.7,1.0027845694104862
02-13-2021,14820,975,8600,6220,6.58,58.03,1.0037250253979004
02-14-2021,14863,978,8679,6184,6.58,58.39,1.0029014844804318
02-15-2021,14906,981,8754,6152,6.58,58.73,1.0028930902240463
02-16-2021,14951,984,8826,6125,6.58,59.03,1.003018918556286
02-17-2021,15001,987,8903,6098,6.58,59.35,1.00334425790917
02-18-2021,15045,990,8982,6063,6.58,59.7,1.002933137790814
02-19-2021,15094,994,9064,6030,6.59,60.05,1.0032568959787305
02-20-2021,15143,996,9144,5999,6.58,60.38,1.0032463230422684
02-21-2021,15179,998,9221,5958,6.57,60.75,1.0023773360628674
02-22-2021,15230,1001,9307,5923,6.57,61.11,1.0033599051320903
02-23-2021,15282,1004,9389,5893,6.57,61.44,1.003414313854235
02-24-2021,15343,1008,9468,5875,6.57,61.71,1.003991624132967
02-25-2021,15405,1014,9553,5852,6.58,62.01,1.004040930717591
02-26-2021,15467,1018,9637,5830,6.58,62.31,1.0040246673158066
02-27-2021,15533,1023,9717,5816,6.59,62.56,1.0042671494148834
02-28-2021,15588,1027,9801,5787,6.59,62.88,1.0035408485160626
03-01-2021,15642,1032,9880,5762,6.6,63.16,1.0034642032332564
03-02-2021,15696,1039,9961,5735,6.62,63.46,1.0034522439585731
03-03-2021,15753,1045,10039,5714,6.63,63.73,1.003631498470948
03-04-2021,15815,1050,10123,5692,6.64,64.01,1.0039357582682664
03-05-2021,15870,1054,10209,5661,6.64,64.33,1.0034777110338287
03-06-2021,15925,1058,10293,5632,6.64,64.63,1.0034656584751103
03-07-2021,15981,1063,10374,5607,6.65,64.91,1.0035164835164836
03-08-2021,16042,1068,10454,5588,6.66,65.17,1.0038170327263625
03-09-2021,16117,1074,10541,5576,6.66,65.4,1.0046752275277397
03-10-2021,16187,1079,10625,5562,6.67,65.64,1.0043432400570826
03-11-2021,16257,1085,10711,5546,6.67,65.89,1.0043244578983135
03-12-2021,16328,1090,10799,5529,6.68,66.14,1.0043673494494678
03-13-2021,16401,1094,10885,5516,6.67,66.37,1.0044708476237139
03-14-2021,16478,1099,10970,5508,6.67,66.57,1.0046948356807512
03-15-2021,16556,1104,11058,5498,6.67,66.79,1.0047335841728364
03-16-2021,16656,1110,11141,5515,6.66,66.89,1.006040106305871
03-17-2021,16776,1120,11231,5545,6.68,66.95,1.0072046109510087
03-18-2021,16925,1130,11322,5603,6.68,66.9,1.0088817358130664
03-19-2021,17077,1141,11410,5667,6.68,66.82,1.0089807976366323
03-20-2021,17240,1153,11503,5737,6.69,66.72,1.0095450020495402
03-21-2021,17411,1163,11599,5812,6.68,66.62,1.0099187935034803
03-22-2021,17583,1175,11693,5890,6.68,66.5,1.0098788122451323
03-23-2021,17743,1183,11794,5949,6.67,66.47,1.0090996985724847
03-24-2021,17896,1195,11907,5989,6.68,66.53,1.0086231189764978
03-25-2021,18046,1206,12022,6024,6.68,66.62,1.0083817612874386
03-26-2021,18201,1216,12142,6059,6.68,66.71,1.0085891610329158
03-27-2021,18356,1227,12257,6099,6.68,66.77,1.0085160156035382
03-28-2021,18498,1239,12377,6121,6.7,66.91,1.0077358901721507
03-29-2021,18638,1247,12492,6146,6.69,67.02,1.0075683857714348
03-30-2021,18775,1254,12610,6165,6.68,67.16,1.007350574095933
03-31-2021,18909,1265,12731,6178,6.69,67.33,1.0071371504660453
04-01-2021,19039,1274,12855,6184,6.69,67.52,1.0068750330530436
04-02-2021,19164,1288,12977,6187,6.72,67.72,1.0065654708755711
04-03-2021,19284,1299,13090,6194,6.74,67.88,1.0062617407639323
04-04-2021,19404,1313,13205,6199,6.77,68.05,1.0062227753578097
04-05-2021,19526,1323,13316,6210,6.78,68.2,1.0062873634302205
04-06-2021,19641,1332,13434,6207,6.78,68.4,1.0058895831199426
04-07-2021,19761,1342,13549,6212,6.79,68.56,1.0061096685504811
04-08-2021,19883,1352,13666,6217,6.8,68.73,1.0061737766307373
04-09-2021,20008,1360,13780,6228,6.8,68.87,1.0062867776492481
04-10-2021,20118,1368,13895,6223,6.8,69.07,1.0054978008796482
04-11-2021,20226,1378,14012,6214,6.81,69.28,1.0053683268714584
04-12-2021,20331,1385,14122,6209,6.81,69.46,1.0051913378819342
04-13-2021,20435,1392,14230,6205,6.81,69.64,1.005115341104717
04-14-2021,20555,1402,14335,6220,6.82,69.74,1.0058722779544897
04-15-2021,20713,1414,14469,6244,6.83,69.85,1.0076866942349794
04-16-2021,20856,1423,14594,6262,6.82,69.98,1.0069038767923526
04-17-2021,21004,1437,14721,6283,6.84,70.09,1.007096279248178
04-18-2021,21142,1446,14841,6301,6.84,70.2,1.006570177109122
04-19-2021,21279,1456,14958,6321,6.84,70.29,1.0064799924321257
04-20-2021,21433,1468,15088,6345,6.85,70.4,1.0072371821984116
04-21-2021,21584,1483,15216,6368,6.87,70.5,1.0070452106564642
04-22-2021,21725,1496,15376,6349,6.89,70.78,1.0065326167531505
04-23-2021,21864,1510,15551,6313,6.91,71.13,1.006398158803222
04-24-2021,21999,1526,15731,6268,6.94,71.51,1.0061745334796925
04-25-2021,22135,1537,15913,6222,6.94,71.89,1.0061820991863266
04-26-2021,22265,1548,16097,6168,6.95,72.3,1.0058730517280325
04-27-2021,22389,1559,16283,6106,6.96,72.73,1.00556927913766
04-28-2021,22513,1572,16471,6042,6.98,73.16,1.0055384340524365
04-29-2021,22631,1583,16661,5970,6.99,73.62,1.0052414160707146
04-30-2021,22733,1592,16821,5912,7.0,73.99,1.0045070920418895
05-01-2021,22818,1598,16992,5826,7.0,74.47,1.0037390577574452
05-02-2021,22898,1603,17171,5727,7.0,74.99,1.0035060040319046
05-03-2021,22977,1610,17339,5638,7.01,75.46,1.0034500829766793
05-04-2021,23051,1617,17529,5522,7.01,76.04,1.003220611916264
05-05-2021,23121,1625,17725,5396,7.03,76.66,1.0030367446097783
05-06-2021,23191,1631,17932,5259,7.03,77.32,1.0030275507114743
05-07-2021,23256,1639,18166,5090,7.05,78.11,1.0028028114354706
05-08-2021,23319,1648,18457,4862,7.07,79.15,1.0027089783281733
05-09-2021,23379,1657,18737,4642,7.09,80.14,1.0025730091341825
05-10-2021,23439,1664,19024,4415,7.1,81.16,1.002566405748749
05-11-2021,23490,1670,19316,4174,7.11,82.23,1.0021758607449123
05-12-2021,23543,1676,19610,3933,7.12,83.29,1.0022562792677736
05-13-2021,23595,1682,19908,3687,7.13,84.37,1.0022087244616233
05-14-2021,23645,1688,20197,3448,7.14,85.42,1.002119093028184
05-15-2021,23693,1693,20483,3210,7.15,86.45,1.0020300274899556
05-16-2021,23738,1698,20780,2958,7.15,87.54,1.0018992951504664
05-17-2021,23788,1705,21073,2715,7.17,88.59,1.0021063274075321
05-18-2021,23830,1710,21360,2470,7.18,89.63,1.0017655960988734
05-19-2021,23884,1714,21460,2424,7.18,89.85,1.0022660511959716
05-20-2021,23939,1720,21489,2450,7.18,89.77,1.0023027968514486
05-21-2021,23996,1724,21514,2482,7.18,89.66,1.0023810518400935
05-22-2021,24052,1729,21534,2518,7.19,89.53,1.0023337222870479
05-23-2021,24117,1734,21549,2568,7.19,89.35,1.0027024779644105
05-24-2021,24187,1740,21560,2627,7.19,89.14,1.0029025168967949
05-25-2021,24252,1745,21569,2683,7.2,88.94,1.0026873940546575
05-26-2021,24315,1750,21577,2738,7.2,88.74,1.0025977238990598
05-27-2021,24365,1754,21583,2782,7.2,88.58,1.0020563438206869
05-28-2021,24410,1758,21588,2822,7.2,88.44,1.0018469115534578
05-29-2021,24440,1763,21593,2847,7.21,88.35,1.0012290045063499
05-30-2021,24467,1766,21598,2869,7.22,88.27,1.0011047463175122
05-31-2021,24495,1770,21604,2891,7.23,88.2,1.001144398577676
06-01-2021,24529,1774,21609,2920,7.23,88.1,1.0013880383751785
06-02-2021,24559,1778,21614,2945,7.24,88.01,1.0012230421134167
