date,total_confirmed,total_deaths,total_recovered,total_infected,mortality_rate,recovery_rate,daily_growth_rate
03-06-2020,1,0,0,1,0,0,1
03-07-2020,1,0,0,1,0,0,1.0
03-08-2020,3,0,0,3,0,0,3.0
03-09-2020,3,0,0,3,0,0,1.0
03-10-2020,7,0,0,7,0,0,2.333333333333333
03-11-2020,10,0,0,10,0,0,1.4285714285714286
03-12-2020,16,0,0,16,0,0,1.6
03-13-2020,32,0,0,32,0,0,2.0
03-14-2020,44,0,0,44,0,0,1.375
03-15-2020,54,0,0,54,0,0,1.2272727272727273
03-16-2020,63,0,0,63,0,0,1.1666666666666667
03-17-2020,72,0,0,72,0,0,1.1428571428571428
03-18-2020,105,1,0,105,0.95,0,1.4583333333333333
03-19-2020,123,1,0,123,0.81,0,1.1714285714285715
03-20-2020,137,1,0,137,0.73,0,1.113821138211382
03-21-2020,178,1,0,178,0.56,0,1.2992700729927007
03-22-2020,185,0,7,178,0,3.78,1.0393258426966292
03-23-2020,186,0,7,179,0,3.76,1.0054054054054054
03-24-2020,204,0,7,197,0,3.43,1.096774193548387
03-25-2020,216,0,7,209,0,3.24,1.0588235294117647
03-26-2020,226,0,2,224,0,0.88,1.0462962962962963
03-27-2020,269,0,2,267,0,0.74,1.1902654867256637
03-28-2020,292,0,2,290,0,0.68,1.0855018587360594
03-29-2020,314,0,2,312,0,0.64,1.0753424657534247
03-30-2020,336,0,7,329,0,2.08,1.070063694267516
03-31-2020,363,0,3,360,0,0.83,1.0803571428571428
04-01-2020,400,1,3,397,0.25,0.75,1.1019283746556474
04-02-2020,426,1,5,421,0.23,1.17,1.065
04-03-2020,450,1,10,440,0.22,2.22,1.056338028169014
04-04-2020,471,1,10,461,0.21,2.12,1.0466666666666666
04-05-2020,485,1,10,475,0.21,2.06,1.029723991507431
04-06-2020,534,2,8,526,0.37,1.5,1.1010309278350516
04-07-2020,581,2,13,568,0.34,2.24,1.0880149812734083
04-08-2020,682,2,16,666,0.29,2.35,1.1738382099827882
04-09-2020,701,2,23,678,0.29,3.28,1.0278592375366569
04-10-2020,715,2,23,692,0.28,3.22,1.0199714693295292
04-11-2020,728,2,23,705,0.27,3.16,1.018181818181818
04-12-2020,742,2,23,719,0.27,3.1,1.0192307692307692
04-13-2020,769,2,107,662,0.26,13.91,1.036388140161725
04-14-2020,835,2,113,722,0.24,13.53,1.0858257477243174
04-15-2020,863,6,151,712,0.7,17.5,1.0335329341317365
04-16-2020,977,8,167,810,0.82,17.09,1.1320973348783314
04-17-2020,1049,9,175,874,0.86,16.68,1.0736949846468782
04-18-2020,1089,11,213,876,1.01,19.56,1.0381315538608198
04-19-2020,1161,12,229,932,1.03,19.72,1.0661157024793388
04-20-2020,1173,13,251,922,1.11,21.4,1.0103359173126616
04-21-2020,1199,14,258,941,1.17,21.52,1.0221653878942882
04-22-2020,1244,14,284,960,1.13,22.83,1.0375312760633861
04-23-2020,1325,15,288,1037,1.13,21.74,1.065112540192926
04-24-2020,1360,17,355,1005,1.25,26.1,1.0264150943396226
04-25-2020,1373,17,386,987,1.24,28.11,1.0095588235294117
04-26-2020,1379,18,394,985,1.31,28.57,1.0043699927166787
04-27-2020,1381,18,403,978,1.3,29.18,1.0014503263234227
04-28-2020,1384,20,423,961,1.45,30.56,1.002172338884866
04-29-2020,1391,22,484,907,1.58,34.8,1.005057803468208
04-30-2020,1396,23,524,872,1.65,37.54,1.0035945363048167
05-01-2020,1403,23,558,845,1.64,39.77,1.0050143266475644
05-02-2020,1407,24,608,799,1.71,43.21,1.0028510334996437
05-03-2020,1408,24,619,789,1.7,43.96,1.0007107320540156
05-04-2020,1413,25,643,770,1.77,45.51,1.0035511363636365
05-05-2020,1421,25,741,680,1.76,52.15,1.005661712668082
05-06-2020,1429,25,762,667,1.75,53.32,1.0056298381421533
05-07-2020,1445,26,806,639,1.8,55.78,1.0111966410076978
05-08-2020,1455,26,905,550,1.79,62.2,1.0069204152249136
05-09-2020,1455,26,919,536,1.79,63.16,1.0
05-10-2020,1457,26,941,516,1.78,64.58,1.0013745704467354
05-11-2020,1457,26,959,498,1.78,65.82,1.0
05-12-2020,1465,27,983,482,1.84,67.1,1.005490734385724
05-13-2020,1469,27,1060,409,1.84,72.16,1.0027303754266212
05-14-2020,1477,27,1112,365,1.83,75.29,1.0054458815520761
05-15-2020,1480,27,1131,349,1.82,76.42,1.002031144211239
05-16-2020,1493,28,1151,342,1.88,77.09,1.0087837837837839
05-17-2020,1494,28,1163,331,1.87,77.84,1.000669792364367
05-18-2020,1495,28,1185,310,1.87,79.26,1.000669344042838
05-19-2020,1495,28,1192,303,1.87,79.73,1.0
05-20-2020,1496,28,1231,265,1.87,82.29,1.0006688963210701
05-21-2020,1502,28,1245,257,1.86,82.89,1.0040106951871657
05-22-2020,1503,28,1256,247,1.86,83.57,1.0006657789613849
05-23-2020,1504,28,1280,224,1.86,85.11,1.0006653359946773
05-24-2020,1509,28,1301,208,1.86,86.22,1.0033244680851063
05-25-2020,1511,28,1307,204,1.85,86.5,1.001325381047051
05-26-2020,1513,28,1322,191,1.85,87.38,1.00132362673726
05-27-2020,1515,28,1327,188,1.85,87.59,1.0013218770654329
05-28-2020,1520,28,1332,188,1.84,87.63,1.0033003300330032
05-29-2020,1520,28,1338,182,1.84,88.03,1.0
05-30-2020,1521,28,1356,165,1.84,89.15,1.000657894736842
05-31-2020,1521,28,1366,155,1.84,89.81,1.0
06-01-2020,1522,28,1368,154,1.84,89.88,1.0006574621959237
06-02-2020,1522,28,1372,150,1.84,90.14,1.0
06-03-2020,1525,28,1375,150,1.84,90.16,1.0019710906701709
06-04-2020,1526,28,1376,150,1.83,90.17,1.0006557377049181
06-05-2020,1526,28,1379,147,1.83,90.37,1.0
06-06-2020,1528,28,1379,149,1.83,90.25,1.001310615989515
06-07-2020,1528,28,1389,139,1.83,90.9,1.0
06-08-2020,1530,28,1396,134,1.83,91.24,1.0013089005235603
06-09-2020,1531,28,1402,129,1.83,91.57,1.0006535947712418
06-10-2020,1533,28,1404,129,1.83,91.59,1.001306335728282
06-11-2020,1541,28,1409,132,1.82,91.43,1.005218525766471
06-12-2020,1542,28,1409,133,1.82,91.37,1.00064892926671
06-13-2020,1545,28,1410,135,1.81,91.26,1.0019455252918288
06-14-2020,1548,28,1410,138,1.81,91.09,1.0019417475728156
06-15-2020,1552,28,1410,142,1.8,90.85,1.0025839793281655
06-16-2020,1552,28,1426,126,1.8,91.88,1.0
06-17-2020,1561,28,1437,124,1.79,92.06,1.005798969072165
06-18-2020,1562,28,1443,119,1.79,92.38,1.0006406149903908
06-19-2020,1576,28,1447,129,1.78,91.81,1.0089628681177978
06-20-2020,1586,28,1447,139,1.77,91.24,1.0063451776649746
06-21-2020,1587,28,1447,140,1.76,91.18,1.0006305170239596
06-22-2020,1588,28,1447,141,1.76,91.12,1.0006301197227474
06-23-2020,1589,28,1448,141,1.76,91.13,1.0006297229219143
06-24-2020,1607,28,1448,159,1.74,90.11,1.0113278791692888
06-25-2020,1630,28,1452,178,1.72,89.08,1.0143123833229621
06-26-2020,1643,28,1455,188,1.7,88.56,1.0079754601226993
06-27-2020,1657,28,1455,202,1.69,87.81,1.008520998174072
06-28-2020,1664,28,1461,203,1.68,87.8,1.0042245021122511
06-29-2020,1665,28,1464,201,1.68,87.93,1.0006009615384615
06-30-2020,1667,28,1464,203,1.68,87.82,1.0012012012012013
07-01-2020,1687,28,1466,221,1.66,86.9,1.011997600479904
07-02-2020,1700,28,1466,234,1.65,86.24,1.007705986959099
07-03-2020,1720,28,1466,254,1.63,85.23,1.011764705882353
07-04-2020,1749,28,1466,283,1.6,83.82,1.0168604651162791
07-05-2020,1764,28,1466,298,1.59,83.11,1.0085763293310464
07-06-2020,1765,28,1466,299,1.59,83.06,1.0005668934240364
07-07-2020,1767,28,1473,294,1.58,83.36,1.0011331444759206
07-08-2020,1798,28,1473,325,1.56,81.92,1.0175438596491229
07-09-2020,1851,28,1477,374,1.51,79.79,1.0294771968854282
07-10-2020,1870,28,1481,389,1.5,79.2,1.010264721772015
07-11-2020,1893,28,1493,400,1.48,78.87,1.0122994652406416
07-12-2020,1901,28,1493,408,1.47,78.54,1.0042260961436873
07-13-2020,1902,28,1493,409,1.47,78.5,1.0005260389268806
07-14-2020,1908,28,1493,415,1.47,78.25,1.003154574132492
07-15-2020,1927,28,1507,420,1.45,78.2,1.009958071278826
07-16-2020,1951,28,1514,437,1.44,77.6,1.0124545926310327
07-17-2020,1965,28,1523,442,1.42,77.51,1.0071758072783188
07-18-2020,1976,28,1523,453,1.42,77.07,1.0055979643765904
07-19-2020,1979,28,1530,449,1.41,77.31,1.0015182186234817
07-20-2020,1980,28,1538,442,1.41,77.68,1.0005053057099544
07-21-2020,2021,28,1538,483,1.39,76.1,1.0207070707070707
07-22-2020,2058,28,1556,502,1.36,75.61,1.0183077684314696
07-23-2020,2089,28,1556,533,1.34,74.49,1.0150631681243927
07-24-2020,2118,28,1577,541,1.32,74.46,1.0138822403063668
07-25-2020,2141,28,1577,564,1.31,73.66,1.0108593012275733
07-26-2020,2179,28,1577,602,1.28,72.37,1.0177487155534797
07-27-2020,2181,28,1616,565,1.28,74.09,1.0009178522257915
07-28-2020,2204,28,1644,560,1.27,74.59,1.0105456212746446
07-29-2020,2245,28,1660,585,1.25,73.94,1.0186025408348458
07-30-2020,2265,28,1675,590,1.24,73.95,1.0089086859688197
07-31-2020,2292,29,1695,597,1.27,73.95,1.0119205298013245
08-01-2020,2337,29,1742,595,1.24,74.54,1.0196335078534031
08-02-2020,2344,29,1742,602,1.24,74.32,1.002995293110826
08-03-2020,2354,29,1746,608,1.23,74.17,1.0042662116040955
08-04-2020,2368,29,1771,597,1.22,74.79,1.005947323704333
08-05-2020,2417,29,1777,640,1.2,73.52,1.0206925675675675
08-06-2020,2480,29,1824,656,1.17,73.55,1.0260653702937526
08-07-2020,2523,31,1846,677,1.23,73.17,1.0173387096774194
08-08-2020,2566,31,1861,705,1.21,72.53,1.0170432025366627
08-09-2020,2596,31,1864,732,1.19,71.8,1.0116913484021823
08-10-2020,2599,31,1866,733,1.19,71.8,1.0011556240369799
08-11-2020,2615,31,1874,741,1.19,71.66,1.006156213928434
08-12-2020,2690,31,1884,806,1.15,70.04,1.02868068833652
08-13-2020,2739,31,1939,800,1.13,70.79,1.0182156133828997
08-14-2020,2801,31,1944,857,1.11,69.4,1.022635998539613
08-15-2020,2855,31,1969,886,1.09,68.97,1.0192788289896466
08-16-2020,2902,31,1969,933,1.07,67.85,1.01646234676007
08-17-2020,2907,31,1969,938,1.07,67.73,1.001722949689869
08-18-2020,2922,31,1980,942,1.06,67.76,1.0051599587203301
08-19-2020,3022,33,1997,1025,1.09,66.08,1.0342231348391513
08-20-2020,3102,33,2014,1088,1.06,64.93,1.026472534745202
08-21-2020,3225,33,2045,1180,1.02,63.41,1.039651837524178
08-22-2020,3316,33,2147,1169,1.0,64.75,1.0282170542635658
08-23-2020,3356,33,2148,1208,0.98,64.0,1.0120627261761157
08-24-2020,3424,33,2153,1271,0.96,62.88,1.0202622169249107
08-25-2020,3452,33,2167,1285,0.96,62.78,1.0081775700934579
08-26-2020,3536,33,2192,1344,0.93,61.99,1.0243337195828506
08-27-2020,3626,33,2206,1420,0.91,60.84,1.0254524886877827
08-28-2020,3728,33,2225,1503,0.89,59.68,1.0281301709873139
08-29-2020,3842,33,2254,1588,0.86,58.67,1.030579399141631
08-30-2020,3876,33,2278,1598,0.85,58.77,1.008849557522124
08-31-2020,3917,33,2377,1540,0.84,60.68,1.010577915376677
09-01-2020,3989,33,2478,1511,0.83,62.12,1.018381414347715
09-02-2020,4042,33,2523,1519,0.82,62.42,1.0132865379794436
09-03-2020,4163,37,2617,1546,0.89,62.86,1.0299356754082138
09-04-2020,4300,37,2693,1607,0.86,62.63,1.0329089598846986
09-05-2020,4526,37,2797,1729,0.82,61.8,1.0525581395348838
09-06-2020,4614,37,2802,1812,0.8,60.73,1.0194432169686256
09-07-2020,4636,37,2836,1800,0.8,61.17,1.0047680970957955
09-08-2020,4727,37,2913,1814,0.78,61.62,1.0196289905090596
09-09-2020,4888,37,2947,1941,0.76,60.29,1.0340596572879204
09-10-2020,5066,37,3001,2065,0.73,59.24,1.036415711947627
09-11-2020,5252,37,3081,2171,0.7,58.66,1.0367153572838532
09-12-2020,5453,38,3114,2339,0.7,57.11,1.0382711348057883
09-13-2020,5532,38,3124,2408,0.69,56.47,1.0144874381074638
09-14-2020,5580,38,3129,2451,0.68,56.08,1.0086767895878526
09-15-2020,5768,38,3214,2554,0.66,55.72,1.0336917562724015
09-16-2020,5860,38,3220,2640,0.65,54.95,1.0159500693481276
09-17-2020,6021,39,3288,2733,0.65,54.61,1.0274744027303755
09-18-2020,6256,39,3390,2866,0.62,54.19,1.0390300614515862
09-19-2020,6546,39,3519,3027,0.6,53.76,1.0463554987212276
09-20-2020,6677,39,3548,3129,0.58,53.14,1.0200122212037885
09-21-2020,6756,39,3571,3185,0.58,52.86,1.0118316609255653
09-22-2020,6931,40,3668,3263,0.58,52.92,1.025902901124926
09-23-2020,7269,41,3888,3381,0.56,53.49,1.048766411773193
09-24-2020,7629,41,3978,3651,0.54,52.14,1.0495253817581511
09-25-2020,8048,41,4036,4012,0.51,50.15,1.0549220081268842
09-26-2020,8600,44,4098,4502,0.51,47.65,1.0685884691848906
09-27-2020,9078,44,4178,4900,0.48,46.02,1.055581395348837
09-28-2020,9343,44,4213,5130,0.47,45.09,1.0291914518616436
09-29-2020,9574,45,4329,5245,0.47,45.22,1.0247243925933853
09-30-2020,10141,48,4395,5746,0.47,43.34,1.0592228953415501
10-01-2020,10938,48,4620,6318,0.44,42.24,1.078591854846662
10-02-2020,11617,54,4756,6861,0.46,40.94,1.0620771621868714
10-03-2020,12321,54,4793,7528,0.44,38.9,1.0606008435912886
10-04-2020,13139,55,4828,8311,0.42,36.75,1.0663907150393637
10-05-2020,13492,55,4865,8627,0.41,36.06,1.026866580409468
10-06-2020,13812,55,5027,8785,0.4,36.4,1.0237177586718056
10-07-2020,14689,55,5200,9489,0.37,35.4,1.0634955111497248
10-08-2020,15726,57,5353,10373,0.36,34.04,1.0705970454081286
10-09-2020,16910,57,5452,11458,0.34,32.24,1.0752893297723516
10-10-2020,18797,61,5553,13244,0.32,29.54,1.1115907746895328
10-11-2020,19851,61,5631,14220,0.31,28.37,1.056072777570889
10-12-2020,20355,61,6031,14324,0.3,29.63,1.0253891491612512
10-13-2020,20886,61,6388,14498,0.29,30.59,1.0260869565217392
10-14-2020,22296,66,6709,15587,0.3,30.09,1.067509336397587
10-15-2020,24225,71,6926,17299,0.29,28.59,1.0865177610333692
10-16-2020,26300,71,7182,19118,0.27,27.31,1.085655314757482
10-17-2020,28268,82,7297,20971,0.29,25.81,1.074828897338403
10-18-2020,29835,88,7359,22476,0.29,24.67,1.0554337059572663
10-19-2020,30695,92,7536,23159,0.3,24.55,1.0288252052957936
10-20-2020,31400,98,8004,23396,0.31,25.49,1.0229679100830755
10-21-2020,33602,98,8404,25198,0.29,25.01,1.0701273885350318
10-22-2020,35330,115,8763,26567,0.33,24.8,1.0514255103862866
10-23-2020,37911,134,8859,29052,0.35,23.37,1.0730540617039344
10-24-2020,40801,159,9920,30881,0.39,24.31,1.0762311730104719
10-25-2020,43843,159,9960,33883,0.36,22.72,1.0745569961520551
10-26-2020,45155,165,10130,35025,0.37,22.43,1.0299249595146318
10-27-2020,46056,176,11008,35048,0.38,23.9,1.019953493522312
10-28-2020,48943,184,11799,37144,0.38,24.11,1.0626845579294772
10-29-2020,51728,200,12227,39501,0.39,23.64,1.0569029278957154
10-30-2020,55091,212,12508,42583,0.38,22.7,1.0650131456851222
10-31-2020,57664,219,12617,45047,0.38,21.88,1.0467045433918425
11-01-2020,59946,219,12798,47148,0.37,21.35,1.0395740843507215
11-02-2020,61829,219,13012,48817,0.35,21.05,1.0314116037767325
11-03-2020,63556,235,14257,49299,0.37,22.43,1.0279318766274725
11-04-2020,66772,261,15474,51298,0.39,23.17,1.0506010447479388
11-05-2020,68734,286,16426,52308,0.42,23.9,1.029383573953154
11-06-2020,71088,317,16990,54098,0.45,23.9,1.0342479704367562
11-07-2020,73667,351,18354,55313,0.48,24.91,1.0362789781679045
11-08-2020,75495,351,19481,56014,0.46,25.8,1.024814367355804
11-09-2020,76072,366,19757,56315,0.48,25.97,1.0076428902576329
11-10-2020,77123,390,21718,55405,0.51,28.16,1.0138158586602166
11-11-2020,79181,414,23247,55934,0.52,29.36,1.0266846466034776
11-12-2020,81772,464,24314,57458,0.57,29.73,1.0327224965585178
11-13-2020,83796,491,26439,57357,0.59,31.55,1.0247517487648583
11-14-2020,85567,510,29024,56543,0.6,33.92,1.02113466036565
11-15-2020,86767,510,30519,56248,0.59,35.17,1.0140240980751924
11-16-2020,87276,526,31053,56223,0.6,35.58,1.0058662855693985
11-17-2020,88602,557,33906,54696,0.63,38.27,1.0151931802557403
11-18-2020,89913,579,35924,53989,0.64,39.95,1.0147965057222184
11-19-2020,91578,579,38695,52883,0.63,42.25,1.0185179006372826
11-20-2020,93396,614,40816,52580,0.66,43.7,1.019851929502719
11-21-2020,95257,644,43188,52069,0.68,45.34,1.0199259068910873
11-22-2020,96241,671,45883,50358,0.7,47.68,1.0103299495050233
11-23-2020,96472,693,47933,48539,0.72,49.69,1.0024002244365706
11-24-2020,97493,709,50738,46755,0.73,52.04,1.0105833817066092
11-25-2020,99304,732,53547,45757,0.74,53.92,1.0185756926138287
11-26-2020,101257,749,56378,44879,0.74,55.68,1.0196668814952066
11-27-2020,103106,771,59285,43821,0.75,57.5,1.0182604659430954
11-28-2020,104632,798,62094,42538,0.76,59.35,1.0148003026012065
11-29-2020,105733,816,64197,41536,0.77,60.72,1.0105225934704487
11-30-2020,105929,839,66041,39888,0.79,62.34,1.00185372589447
12-01-2020,107183,868,68859,38324,0.81,64.24,1.0118381179846878
12-02-2020,109226,898,71738,37488,0.82,65.68,1.01906085853167
12-03-2020,111208,930,74273,36935,0.84,66.79,1.0181458627066815
12-04-2020,113392,957,77142,36250,0.84,68.03,1.0196388749010863
12-05-2020,115462,981,79956,35506,0.85,69.25,1.0182552561027234
12-06-2020,116731,996,82666,34065,0.85,70.82,1.0109906289515165
12-07-2020,117283,1018,84850,32433,0.87,72.35,1.0047288209644396
12-08-2020,119232,1046,87433,31799,0.88,73.33,1.0166179241663327
12-09-2020,121796,1084,89769,32027,0.89,73.7,1.0215042941492216
12-10-2020,124921,1104,91455,33466,0.88,73.21,1.0256576570659135
12-11-2020,127087,1122,93533,33554,0.88,73.6,1.0173389582215961
12-12-2020,130794,1148,95416,35378,0.88,72.95,1.0291689944683564
12-13-2020,132984,1175,97068,35916,0.88,72.99,1.0167438873342813
12-14-2020,133489,1205,98585,34904,0.9,73.85,1.003797449317211
12-15-2020,135523,1251,100303,35220,0.92,74.01,1.0152372105566752
12-16-2020,139088,1309,101584,37504,0.94,73.04,1.026305497959756
12-17-2020,142133,1378,102737,39396,0.97,72.28,1.021892614747498
12-18-2020,146124,1440,104560,41564,0.99,71.56,1.0280793341447798
12-19-2020,149275,1510,106361,42914,1.01,71.25,1.0215638772549342
12-20-2020,151336,1555,107828,43508,1.03,71.25,1.013806732540613
12-21-2020,152555,1618,109807,42748,1.06,71.98,1.0080549241423058
12-22-2020,155218,1618,110565,44653,1.04,71.23,1.017455999475599
12-23-2020,158905,1686,112627,46278,1.06,70.88,1.023753688360886
12-24-2020,161562,1732,114267,47295,1.07,70.73,1.0167206821685912
12-25-2020,165608,1732,115663,49945,1.05,69.84,1.0250430175412535
12-26-2020,166649,1732,116948,49701,1.04,70.18,1.0062859282160281
12-27-2020,167523,1773,119086,48437,1.06,71.09,1.005244555922928
12-28-2020,168092,1879,120410,47682,1.12,71.63,1.0033965485336342
12-29-2020,170187,1983,121760,48427,1.17,71.54,1.0124634128929395
12-30-2020,173228,2065,124427,48801,1.19,71.83,1.0178685798562757
12-31-2020,179543,2138,125971,53572,1.19,70.16,1.036454845636964
01-01-2021,184508,2250,127190,57318,1.22,68.93,1.0276535426053925
01-02-2021,186244,2250,128285,57959,1.21,68.88,1.0094088061222277
01-03-2021,187463,2317,129994,57469,1.24,69.34,1.0065451772943022
01-04-2021,188099,2521,130897,57202,1.34,69.59,1.0033926694867787
01-05-2021,191088,2603,132852,58236,1.36,69.52,1.015890568264584
01-06-2021,196047,2657,135760,60287,1.36,69.25,1.02595139412208
01-07-2021,198184,2717,138383,59801,1.37,69.83,1.010900447341709
01-08-2021,201164,2788,141490,59674,1.39,70.34,1.0150365317079078
01-09-2021,205236,2836,144612,60624,1.38,70.46,1.020242190451572
01-10-2021,208209,2918,147275,60934,1.4,70.73,1.0144857627316846
01-11-2021,209069,3007,150239,58830,1.44,71.86,1.0041304650615488
01-12-2021,211479,3102,153755,57724,1.47,72.7,1.011527294816544
01-13-2021,215055,3163,157028,58027,1.47,73.02,1.0169094803739378
01-14-2021,217978,3260,160401,57577,1.5,73.59,1.013591871846737
01-15-2021,220707,3362,163323,57384,1.52,74.0,1.012519612070943
01-16-2021,222752,3417,166555,56197,1.53,74.77,1.0092656780256177
01-17-2021,223325,3474,168915,54410,1.56,75.64,1.0025723674759375
01-18-2021,224385,3526,171092,53293,1.57,76.25,1.0047464457629016
01-19-2021,226294,3637,173761,52533,1.61,76.79,1.0085076988212225
01-20-2021,228778,3737,176864,51914,1.63,77.31,1.0109768707963975
01-21-2021,231242,3801,181129,50113,1.64,78.33,1.0107702663717666
01-22-2021,233027,3894,183942,49085,1.67,78.94,1.007719185961028
01-23-2021,234571,3965,186683,47888,1.69,79.58,1.0066258416406682
01-24-2021,236476,4068,189959,46517,1.72,80.33,1.008121208504035
01-25-2021,237027,4068,193380,43647,1.72,81.59,1.0023300461780478
01-26-2021,238617,4260,197191,41426,1.79,82.64,1.0067080965459632
01-27-2021,241392,4361,202148,39244,1.81,83.74,1.0116295150806522
01-28-2021,243427,4411,205247,38180,1.81,84.32,1.0084302710943196
01-29-2021,246008,4495,208406,37602,1.83,84.72,1.0106027679756149
01-30-2021,248190,4565,212271,35919,1.84,85.53,1.0088696302559266
01-31-2021,249913,4642,216052,33861,1.86,86.45,1.0069422619767114
02-01-2021,250357,4711,218923,31434,1.88,87.44,1.0017766182631556
02-02-2021,252094,4784,222642,29452,1.9,88.32,1.006938092404047
02-03-2021,254826,4889,226471,28355,1.92,88.87,1.0108372273834363
02-04-2021,256903,4976,230456,26447,1.94,89.71,1.0081506596658112
02-05-2021,259533,5050,234371,25162,1.95,90.3,1.010237326928841
02-06-2021,261774,5135,238221,23553,1.96,91.0,1.0086347400908555
02-07-2021,263326,5199,241686,21640,1.97,91.78,1.005928778259109
02-08-2021,264083,5271,245702,18381,2.0,93.04,1.0028747636010116
02-09-2021,265807,5382,248386,17421,2.02,93.45,1.0065282505878834
02-10-2021,268986,5502,251618,17368,2.05,93.54,1.0119598054227315
02-11-2021,271473,5629,253518,17955,2.07,93.39,1.0092458343556914
02-12-2021,273904,5733,255300,18604,2.09,93.21,1.0089548500219174
02-13-2021,276234,5812,255300,20934,2.1,92.42,1.008506630060167
02-14-2021,277682,5885,255300,22382,2.12,91.94,1.00524193256442
02-15-2021,278254,5952,255300,22954,2.14,91.75,1.0020599102570567
02-16-2021,279696,6063,255300,24396,2.17,91.28,1.0051823154384123
02-17-2021,282864,6168,255300,27564,2.18,90.26,1.0113265831474172
02-18-2021,285419,6271,255300,30119,2.2,89.45,1.0090326093104813
02-19-2021,287752,6350,255300,32452,2.21,88.72,1.0081739477750256
02-20-2021,290457,6424,255300,35157,2.21,87.9,1.0094004559481775
02-21-2021,292143,6505,255300,36843,2.23,87.39,1.0058046457823362
02-22-2021,292792,6577,255300,37492,2.25,87.2,1.0022215148061053
02-23-2021,294790,6671,255300,39490,2.26,86.6,1.006823956938714
02-24-2021,298337,6775,255300,43037,2.27,85.57,1.0120322941755149
02-25-2021,300775,6859,255300,45475,2.28,84.88,1.0081719666015279
02-26-2021,303420,6966,255300,48120,2.3,84.14,1.0087939489651734
02-27-2021,306268,7075,255300,50968,2.31,83.36,1.0093863291806737
02-28-2021,308083,7189,255300,52783,2.33,82.87,1.0059261822978567
03-01-2021,308925,7270,255300,53625,2.35,82.64,1.0027330297354933
03-02-2021,311002,7388,255300,55702,2.38,82.09,1.0067233147204013
03-03-2021,314359,7489,255300,59059,2.38,81.21,1.01079414280294
03-04-2021,317159,7560,255300,61859,2.38,80.5,1.0089070139553822
03-05-2021,319582,7665,255300,64282,2.4,79.89,1.0076397012224152
03-06-2021,322104,7739,255300,66804,2.4,79.26,1.0078915583480923
03-07-2021,323390,7836,255300,68090,2.42,78.94,1.0039924993169909
03-08-2021,323786,7921,255300,68486,2.45,78.85,1.0012245276601008
03-09-2021,325993,8037,255300,70693,2.47,78.31,1.0068162304732138
03-10-2021,329593,8146,255300,74293,2.47,77.46,1.011043181908814
03-11-2021,331571,8244,255300,76271,2.49,77.0,1.0060013410478985
03-12-2021,333872,8346,255300,78572,2.5,76.47,1.0069396901417795
03-13-2021,336235,8440,255300,80935,2.51,75.93,1.0070775626587434
03-14-2021,337503,8528,255300,82203,2.53,75.64,1.003771171948191
03-15-2021,337960,8605,255300,82660,2.55,75.54,1.001354062037967
03-16-2021,339538,8669,255300,84238,2.55,75.19,1.00466919162031
03-17-2021,342430,8738,255300,87130,2.55,74.56,1.0085174560726635
03-18-2021,344470,8814,255300,89170,2.56,74.11,1.0059574219548522
03-19-2021,346149,8894,255300,90849,2.57,73.75,1.0048741544982147
03-20-2021,347944,8978,255300,92644,2.58,73.37,1.0051856281543496
03-21-2021,348869,9044,255300,93569,2.59,73.18,1.0026584737773894
03-22-2021,349270,9104,255300,93970,2.61,73.1,1.0011494285820752
03-23-2021,350551,9190,255300,95251,2.62,72.83,1.0036676496693102
03-24-2021,352528,9261,255300,97228,2.63,72.42,1.0056396929405422
03-25-2021,354182,9313,255300,98882,2.63,72.08,1.0046918258975173
03-26-2021,355454,9373,255300,100154,2.64,71.82,1.0035913739263995
03-27-2021,356985,9426,255300,101685,2.64,71.52,1.0043071677347843
03-28-2021,357910,9496,255300,102610,2.65,71.33,1.0025911452862164
03-29-2021,358115,9542,255300,102815,2.66,71.29,1.0005727696907043
03-30-2021,359330,9624,255300,104030,2.68,71.05,1.0033927648939587
03-31-2021,361185,9719,255300,105885,2.69,70.68,1.0051623855508864
04-01-2021,362489,9790,255300,107189,2.7,70.43,1.0036103381923391
04-02-2021,363874,9877,255300,108574,2.71,70.16,1.0038208055968596
04-03-2021,364622,9948,255300,109322,2.73,70.02,1.0020556566283934
04-04-2021,365242,10025,255300,109942,2.74,69.9,1.0017003910899507
04-05-2021,365400,10094,255300,110100,2.76,69.87,1.0004325898992996
04-06-2021,365733,10094,255300,110433,2.76,69.81,1.0009113300492611
04-07-2021,366894,10243,255300,111594,2.79,69.58,1.0031744469325983
04-08-2021,368470,10322,255300,113170,2.8,69.29,1.004295518596652
04-09-2021,369393,10411,255300,114093,2.82,69.11,1.0025049529133987
04-10-2021,370473,10487,255300,115173,2.83,68.91,1.0029237153925494
04-11-2021,371062,10565,255300,115762,2.85,68.8,1.0015898594499464
04-12-2021,371168,10630,255300,115868,2.86,68.78,1.0002856665462914
04-13-2021,372038,10716,255300,116738,2.88,68.62,1.0023439520648332
04-14-2021,373107,10798,255300,117807,2.89,68.43,1.0028733623984647
04-15-2021,373950,10877,255300,118650,2.91,68.27,1.0022594054788572
04-16-2021,374586,10970,255300,119286,2.93,68.16,1.001700762133975
04-17-2021,375336,11043,255300,120036,2.94,68.02,1.0020022104403261
04-18-2021,375974,11106,255300,120674,2.95,67.9,1.0016998103033017
04-19-2021,376067,11172,255300,120767,2.97,67.89,1.000247357530042
04-20-2021,376709,11244,255300,121409,2.98,67.77,1.0017071426102264
04-21-2021,377473,11304,255300,122173,2.99,67.63,1.002028090648219
04-22-2021,378150,11357,255300,122850,3.0,67.51,1.0017935057606768
04-23-2021,378635,11405,255300,123335,3.01,67.43,1.001282559830755
04-24-2021,379476,11458,255300,124176,3.02,67.28,1.0022211364506715
04-25-2021,379911,11495,255300,124611,3.03,67.2,1.0011463175536792
04-26-2021,380010,11531,255300,124710,3.03,67.18,1.0002605873480894
04-27-2021,380498,11572,255300,125198,3.04,67.1,1.0012841767321912
04-28-2021,381180,11611,255300,125880,3.05,66.98,1.0017923878706327
04-29-2021,381744,11647,255300,126444,3.05,66.88,1.001479615929482
04-30-2021,382211,11684,255300,126911,3.06,66.8,1.0012233329142042
05-01-2021,382720,11732,255300,127420,3.07,66.71,1.0013317251465814
05-02-2021,383098,11766,255300,127798,3.07,66.64,1.0009876672240803
05-03-2021,383228,11807,255300,127928,3.08,66.62,1.0003393387592732
05-04-2021,383609,11855,255300,128309,3.09,66.55,1.0009941862285636
05-05-2021,384317,11886,255300,129017,3.09,66.43,1.0018456292735571
05-06-2021,384660,11920,255300,129360,3.1,66.37,1.0008924923956004
05-07-2021,385022,11946,255300,129722,3.1,66.31,1.0009410908334633
05-08-2021,385395,11990,255300,130095,3.11,66.24,1.0009687758102135
05-09-2021,385475,12019,255300,130175,3.12,66.23,1.0002075792368867
05-10-2021,385786,12051,255300,130486,3.12,66.18,1.0008067968091316
05-11-2021,386136,12077,255300,130836,3.13,66.12,1.0009072387282067
05-12-2021,386540,12096,255300,131240,3.13,66.05,1.0010462634926554
05-13-2021,386868,12135,255300,131568,3.14,65.99,1.0008485538366017
05-14-2021,387162,12168,255300,131862,3.14,65.94,1.0007599491299357
05-15-2021,387420,12203,255300,132120,3.15,65.9,1.0006663877136703
05-16-2021,387523,12224,255300,132223,3.15,65.88,1.000265861339115
05-17-2021,387659,12238,255300,132359,3.16,65.86,1.0003509469115381
05-18-2021,387892,12248,255300,132592,3.16,65.82,1.0006010437007782
05-19-2021,388138,12262,255300,132838,3.16,65.78,1.0006341971476596
05-20-2021,388391,12272,255300,133091,3.16,65.73,1.00065183001922
05-21-2021,388529,12280,255300,133229,3.16,65.71,1.000355312043791
05-22-2021,388719,12286,255300,133419,3.16,65.68,1.0004890239853397
05-23-2021,388835,12292,255300,133535,3.16,65.66,1.0002984160794817
05-24-2021,388854,12296,255300,133554,3.16,65.65,1.0000488639139995
05-25-2021,388986,12301,255300,133686,3.16,65.63,1.0003394590257526
05-26-2021,389176,12312,255300,133876,3.16,65.6,1.0004884494557644
05-27-2021,389344,12320,255300,134044,3.16,65.57,1.0004316812958662
05-28-2021,389440,12333,255300,134140,3.17,65.56,1.000246568587162
05-29-2021,389440,12333,255300,134140,3.17,65.56,1.0
05-30-2021,389690,12339,255300,134390,3.17,65.51,1.0006419474116681
05-31-2021,389721,12343,255300,134421,3.17,65.51,1.0000795504118658
06-01-2021,389866,12353,255300,134566,3.17,65.48,1.0003720610385378
06-02-2021,389990,12366,255300,134690,3.17,65.46,1.000318057999415
06-03-2021,390129,12375,255300,134829,3.17,65.44,1.0003564193953691
06-04-2021,390223,12382,255300,134923,3.17,65.42,1.0002409459435213
06-05-2021,390340,12395,255300,135040,3.18,65.4,1.0002998285595672
06-06-2021,390436,12404,255300,135136,3.18,65.39,1.0002459394374135
06-07-2021,390451,12414,255300,135151,3.18,65.39,1.0000384185884499
06-08-2021,390546,12423,255300,135246,3.18,65.37,1.0002433083792845
06-09-2021,390693,12430,255300,135393,3.18,65.35,1.0003763961223517
06-10-2021,390809,12433,255300,135509,3.18,65.33,1.0002969083142006
06-11-2021,390893,12433,255300,135593,3.18,65.31,1.0002149387552488
06-12-2021,390984,12436,255300,135684,3.18,65.3,1.0002328002803835
06-13-2021,391026,12439,255300,135726,3.18,65.29,1.000107421275551
06-14-2021,391038,12441,255300,135738,3.18,65.29,1.0000306884964172
06-15-2021,391087,12446,255300,135787,3.18,65.28,1.0001253075148706
06-16-2021,391149,12456,255300,135849,3.18,65.27,1.0001585325004412
06-17-2021,391210,12464,255300,135910,3.19,65.26,1.000155950801357
06-18-2021,391248,12478,255300,135948,3.19,65.25,1.0000971345313259
06-19-2021,391248,12478,255300,135948,3.19,65.25,1.0
06-20-2021,391248,12478,255300,135948,3.19,65.25,1.0
06-21-2021,391326,12496,255300,136026,3.19,65.24,1.0001993620414673
06-22-2021,391385,12502,255300,136085,3.19,65.23,1.0001507694352023
06-23-2021,391420,12502,255300,136120,3.19,65.22,1.0000894260127495
06-24-2021,391456,12502,255300,136156,3.19,65.22,1.000091972816923
06-25-2021,391490,12505,255300,136190,3.19,65.21,1.000086855227663
06-26-2021,391531,12505,255300,136231,3.19,65.21,1.0001047280901172
06-27-2021,391551,12505,255300,136251,3.19,65.2,1.0000510815235575
06-28-2021,391566,12509,255300,136266,3.19,65.2,1.0000383091857765
06-29-2021,391609,12510,255300,136309,3.19,65.19,1.000109815458952
06-30-2021,391642,12510,255300,136342,3.19,65.19,1.000084267726227
07-01-2021,391659,12511,255300,136359,3.19,65.18,1.0000434069890358
07-02-2021,391676,12511,255300,136376,3.19,65.18,1.000043405104951
07-03-2021,391696,12513,255300,136396,3.19,65.18,1.000051062612976
07-04-2021,391717,12513,255300,136417,3.19,65.17,1.0000536130060047
07-05-2021,391720,12513,255300,136420,3.19,65.17,1.0000076585902578
07-06-2021,391735,12514,255300,136435,3.19,65.17,1.0000382926580211
07-07-2021,391780,12516,255300,136480,3.19,65.16,1.0001148735752485
07-08-2021,391813,12516,255300,136513,3.19,65.16,1.000084230945939
07-09-2021,391852,12517,255300,136552,3.19,65.15,1.0000995372792634
07-10-2021,391893,12519,255300,136593,3.19,65.15,1.000104631340404
07-11-2021,391918,12519,255300,136618,3.19,65.14,1.0000637929230682
07-12-2021,391925,12521,255300,136625,3.19,65.14,1.0000178608790615
07-13-2021,391953,12522,255300,136653,3.19,65.14,1.0000714422402246
07-14-2021,391971,12523,255300,136671,3.19,65.13,1.0000459238735258
07-15-2021,392000,12524,255300,136700,3.19,65.13,1.0000739850652216
07-16-2021,392034,12524,255300,136734,3.19,65.12,1.0000867346938775
07-17-2021,392034,12524,255300,136734,3.19,65.12,1.0
07-18-2021,392100,12524,255300,136800,3.19,65.11,1.000168352744915
