date,total_confirmed,total_deaths,total_recovered,total_infected,mortality_rate,recovery_rate,daily_growth_rate
03-06-2020,1,0,0,1,0.0,0.0,1
03-07-2020,1,0,0,1,0.0,0.0,1.0
03-08-2020,3,0,0,3,0.0,0.0,3.0
03-09-2020,3,0,0,3,0.0,0.0,1.0
03-10-2020,7,0,0,7,0.0,0.0,2.333333333333333
03-11-2020,10,0,0,10,0.0,0.0,1.4285714285714286
03-12-2020,16,0,0,16,0.0,0.0,1.6
03-13-2020,32,0,0,32,0.0,0.0,2.0
03-14-2020,44,0,0,44,0.0,0.0,1.375
03-15-2020,54,0,0,54,0.0,0.0,1.2272727272727273
03-16-2020,63,0,0,63,0.0,0.0,1.1666666666666667
03-17-2020,72,0,0,72,0.0,0.0,1.1428571428571428
03-18-2020,105,1,0,105,0.95,0.0,1.4583333333333333
03-19-2020,123,1,0,123,0.81,0.0,1.1714285714285715
03-20-2020,137,1,0,137,0.73,0.0,1.113821138211382
03-21-2020,178,1,0,178,0.56,0.0,1.2992700729927007
03-22-2020,185,0,7,178,0.0,3.78,1.0393258426966292
03-23-2020,186,0,7,179,0.0,3.76,1.0054054054054054
03-24-2020,204,0,7,197,0.0,3.43,1.096774193548387
03-25-2020,216,0,7,209,0.0,3.24,1.0588235294117647
03-26-2020,226,0,2,224,0.0,0.88,1.0462962962962963
03-27-2020,269,0,2,267,0.0,0.74,1.1902654867256637
03-28-2020,292,0,2,290,0.0,0.68,1.0855018587360594
03-29-2020,314,0,2,312,0.0,0.64,1.0753424657534247
03-30-2020,336,0,7,329,0.0,2.08,1.070063694267516
03-31-2020,363,0,3,360,0.0,0.83,1.0803571428571428
04-01-2020,400,1,3,397,0.25,0.75,1.1019283746556474
04-02-2020,426,1,5,421,0.23,1.17,1.065
04-03-2020,450,1,10,440,0.22,2.22,1.056338028169014
04-04-2020,471,1,10,461,0.21,2.12,1.0466666666666666
04-05-2020,485,1,10,475,0.21,2.06,1.029723991507431
04-06-2020,534,2,8,526,0.37,1.5,1.1010309278350516
04-07-2020,581,2,13,568,0.34,2.24,1.0880149812734083
04-08-2020,682,2,16,666,0.29,2.35,1.1738382099827882
04-09-2020,701,2,23,678,0.29,3.28,1.0278592375366569
04-10-2020,715,2,23,692,0.28,3.22,1.0199714693295292
04-11-2020,728,2,23,705,0.27,3.16,1.018181818181818
04-12-2020,742,2,23,719,0.27,3.1,1.0192307692307692
04-13-2020,769,2,107,662,0.26,13.91,1.036388140161725
04-14-2020,835,2,113,722,0.24,13.53,1.0858257477243174
04-15-2020,863,6,151,712,0.7,17.5,1.0335329341317365
04-16-2020,977,8,167,810,0.82,17.09,1.1320973348783314
04-17-2020,1049,9,175,874,0.86,16.68,1.0736949846468782
04-18-2020,1089,11,213,876,1.01,19.56,1.0381315538608198
04-19-2020,1161,12,229,932,1.03,19.72,1.0661157024793388
04-20-2020,1173,13,251,922,1.11,21.4,1.0103359173126616
04-21-2020,1199,14,258,941,1.17,21.52,1.0221653878942882
04-22-2020,1244,14,284,960,1.13,22.83,1.0375312760633861
04-23-2020,1325,15,288,1037,1.13,21.74,1.065112540192926
04-24-2020,1360,17,355,1005,1.25,26.1,1.0264150943396226
04-25-2020,1373,17,386,987,1.24,28.11,1.0095588235294117
04-26-2020,1379,18,394,985,1.31,28.57,1.0043699927166787
04-27-2020,1381,18,403,978,1.3,29.18,1.0014503263234227
04-28-2020,1384,20,423,961,1.45,30.56,1.002172338884866
04-29-2020,1391,22,484,907,1.58,34.8,1.005057803468208
04-30-2020,1396,23,524,872,1.65,37.54,1.0035945363048167
05-01-2020,1403,23,558,845,1.64,39.77,1.0050143266475644
05-02-2020,1407,24,608,799,1.71,43.21,1.0028510334996437
05-03-2020,1408,24,619,789,1.7,43.96,1.0007107320540156
05-04-2020,1413,25,643,770,1.77,45.51,1.0035511363636365
05-05-2020,1421,25,741,680,1.76,52.15,1.005661712668082
05-06-2020,1429,25,762,667,1.75,53.32,1.0056298381421533
05-07-2020,1445,26,806,639,1.8,55.78,1.0111966410076978
05-08-2020,1455,26,905,550,1.79,62.2,1.0069204152249136
05-09-2020,1455,26,919,536,1.79,63.16,1.0
05-10-2020,1457,26,941,516,1.78,64.58,1.0013745704467354
05-11-2020,1457,26,959,498,1.78,65.82,1.0
05-12-2020,1465,27,983,482,1.84,67.1,1.005490734385724
05-13-2020,1469,27,1060,409,1.84,72.16,1.0027303754266212
05-14-2020,1477,27,1112,365,1.83,75.29,1.0054458815520761
05-15-2020,1480,27,1131,349,1.82,76.42,1.002031144211239
05-16-2020,1493,28,1151,342,1.88,77.09,1.0087837837837839
05-17-2020,1494,28,1163,331,1.87,77.84,1.000669792364367
05-18-2020,1495,28,1185,310,1.87,79.26,1.000669344042838
05-19-2020,1495,28,1192,303,1.87,79.73,1.0
05-20-2020,1496,28,1231,265,1.87,82.29,1.0006688963210701
05-21-2020,1502,28,1245,257,1.86,82.89,1.0040106951871657
05-22-2020,1503,28,1256,247,1.86,83.57,1.0006657789613849
05-23-2020,1504,28,1280,224,1.86,85.11,1.0006653359946773
05-24-2020,1509,28,1301,208,1.86,86.22,1.0033244680851063
05-25-2020,1511,28,1307,204,1.85,86.5,1.001325381047051
05-26-2020,1513,28,1322,191,1.85,87.38,1.00132362673726
05-27-2020,1515,28,1327,188,1.85,87.59,1.0013218770654329
05-28-2020,1520,28,1332,188,1.84,87.63,1.0033003300330032
05-29-2020,1520,28,1338,182,1.84,88.03,1.0
05-30-2020,1521,28,1356,165,1.84,89.15,1.000657894736842
05-31-2020,1521,28,1366,155,1.84,89.81,1.0
06-01-2020,1522,28,1368,154,1.84,89.88,1.0006574621959237
06-02-2020,1522,28,1372,150,1.84,90.14,1.0
06-03-2020,1525,28,1375,150,1.84,90.16,1.0019710906701709
06-04-2020,1526,28,1376,150,1.83,90.17,1.0006557377049181
06-05-2020,1526,28,1379,147,1.83,90.37,1.0
06-06-2020,1528,28,1379,149,1.83,90.25,1.001310615989515
06-07-2020,1528,28,1389,139,1.83,90.9,1.0
06-08-2020,1530,28,1396,134,1.83,91.24,1.0013089005235603
06-09-2020,1531,28,1402,129,1.83,91.57,1.0006535947712418
06-10-2020,1533,28,1404,129,1.83,91.59,1.001306335728282
06-11-2020,1541,28,1409,132,1.82,91.43,1.005218525766471
06-12-2020,1542,28,1409,133,1.82,91.37,1.00064892926671
06-13-2020,1545,28,1410,135,1.81,91.26,1.0019455252918288
06-14-2020,1548,28,1410,138,1.81,91.09,1.0019417475728156
06-15-2020,1552,28,1410,142,1.8,90.85,1.0025839793281655
06-16-2020,1552,28,1426,126,1.8,91.88,1.0
06-17-2020,1561,28,1437,124,1.79,92.06,1.005798969072165
06-18-2020,1562,28,1443,119,1.79,92.38,1.0006406149903908
06-19-2020,1576,28,1447,129,1.78,91.81,1.0089628681177978
06-20-2020,1586,28,1447,139,1.77,91.24,1.0063451776649746
06-21-2020,1587,28,1447,140,1.76,91.18,1.0006305170239596
06-22-2020,1588,28,1447,141,1.76,91.12,1.0006301197227474
06-23-2020,1589,28,1448,141,1.76,91.13,1.0006297229219143
06-24-2020,1607,28,1448,159,1.74,90.11,1.0113278791692888
06-25-2020,1630,28,1452,178,1.72,89.08,1.0143123833229621
06-26-2020,1643,28,1455,188,1.7,88.56,1.0079754601226993
06-27-2020,1657,28,1455,202,1.69,87.81,1.008520998174072
06-28-2020,1664,28,1461,203,1.68,87.8,1.0042245021122511
06-29-2020,1665,28,1464,201,1.68,87.93,1.0006009615384615
06-30-2020,1667,28,1464,203,1.68,87.82,1.0012012012012013
07-01-2020,1687,28,1466,221,1.66,86.9,1.011997600479904
07-02-2020,1700,28,1466,234,1.65,86.24,1.007705986959099
07-03-2020,1720,28,1466,254,1.63,85.23,1.011764705882353
07-04-2020,1749,28,1466,283,1.6,83.82,1.0168604651162791
07-05-2020,1764,28,1466,298,1.59,83.11,1.0085763293310464
07-06-2020,1765,28,1466,299,1.59,83.06,1.0005668934240364
07-07-2020,1767,28,1473,294,1.58,83.36,1.0011331444759206
07-08-2020,1798,28,1473,325,1.56,81.92,1.0175438596491229
07-09-2020,1851,28,1477,374,1.51,79.79,1.0294771968854282
07-10-2020,1870,28,1481,389,1.5,79.2,1.010264721772015
07-11-2020,1893,28,1493,400,1.48,78.87,1.0122994652406416
07-12-2020,1901,28,1493,408,1.47,78.54,1.0042260961436873
07-13-2020,1902,28,1493,409,1.47,78.5,1.0005260389268806
07-14-2020,1908,28,1493,415,1.47,78.25,1.003154574132492
07-15-2020,1927,28,1507,420,1.45,78.2,1.009958071278826
07-16-2020,1951,28,1514,437,1.44,77.6,1.0124545926310327
07-17-2020,1965,28,1523,442,1.42,77.51,1.0071758072783188
07-18-2020,1976,28,1523,453,1.42,77.07,1.0055979643765904
07-19-2020,1979,28,1530,449,1.41,77.31,1.0015182186234817
07-20-2020,1980,28,1538,442,1.41,77.68,1.0005053057099544
07-21-2020,2021,28,1538,483,1.39,76.1,1.0207070707070707
07-22-2020,2058,28,1556,502,1.36,75.61,1.0183077684314696
07-23-2020,2089,28,1556,533,1.34,74.49,1.0150631681243927
07-24-2020,2118,28,1577,541,1.32,74.46,1.0138822403063668
07-25-2020,2141,28,1577,564,1.31,73.66,1.0108593012275733
07-26-2020,2179,28,1577,602,1.28,72.37,1.0177487155534797
07-27-2020,2181,28,1616,565,1.28,74.09,1.0009178522257915
07-28-2020,2204,28,1644,560,1.27,74.59,1.0105456212746446
07-29-2020,2245,28,1660,585,1.25,73.94,1.0186025408348458
07-30-2020,2265,28,1675,590,1.24,73.95,1.0089086859688197
07-31-2020,2292,29,1695,597,1.27,73.95,1.0119205298013245
08-01-2020,2337,29,1742,595,1.24,74.54,1.0196335078534031
08-02-2020,2344,29,1742,602,1.24,74.32,1.002995293110826
08-03-2020,2354,29,1746,608,1.23,74.17,1.0042662116040955
08-04-2020,2368,29,1771,597,1.22,74.79,1.005947323704333
08-05-2020,2417,29,1777,640,1.2,73.52,1.0206925675675675
08-06-2020,2480,29,1824,656,1.17,73.55,1.0260653702937526
08-07-2020,2523,31,1846,677,1.23,73.17,1.0173387096774194
08-08-2020,2566,31,1861,705,1.21,72.53,1.0170432025366627
08-09-2020,2596,31,1864,732,1.19,71.8,1.0116913484021823
08-10-2020,2599,31,1866,733,1.19,71.8,1.0011556240369799
08-11-2020,2615,31,1874,741,1.19,71.66,1.006156213928434
08-12-2020,2690,31,1884,806,1.15,70.04,1.02868068833652
08-13-2020,2739,31,1939,800,1.13,70.79,1.0182156133828997
08-14-2020,2801,31,1944,857,1.11,69.4,1.022635998539613
08-15-2020,2855,31,1969,886,1.09,68.97,1.0192788289896466
08-16-2020,2902,31,1969,933,1.07,67.85,1.01646234676007
08-17-2020,2907,31,1969,938,1.07,67.73,1.001722949689869
08-18-2020,2922,31,1980,942,1.06,67.76,1.0051599587203301
08-19-2020,3022,33,1997,1025,1.09,66.08,1.0342231348391513
08-20-2020,3102,33,2014,1088,1.06,64.93,1.026472534745202
08-21-2020,3225,33,2045,1180,1.02,63.41,1.039651837524178
08-22-2020,3316,33,2147,1169,1.0,64.75,1.0282170542635658
08-23-2020,3356,33,2148,1208,0.98,64.0,1.0120627261761157
08-24-2020,3424,33,2153,1271,0.96,62.88,1.0202622169249107
08-25-2020,3452,33,2167,1285,0.96,62.78,1.0081775700934579
08-26-2020,3536,33,2192,1344,0.93,61.99,1.0243337195828506
08-27-2020,3626,33,2206,1420,0.91,60.84,1.0254524886877827
08-28-2020,3728,33,2225,1503,0.89,59.68,1.0281301709873139
08-29-2020,3842,33,2254,1588,0.86,58.67,1.030579399141631
08-30-2020,3876,33,2278,1598,0.85,58.77,1.008849557522124
08-31-2020,3917,33,2377,1540,0.84,60.68,1.010577915376677
09-01-2020,3989,33,2478,1511,0.83,62.12,1.018381414347715
09-02-2020,4042,33,2523,1519,0.82,62.42,1.0132865379794436
09-03-2020,4163,37,2617,1546,0.89,62.86,1.0299356754082138
09-04-2020,4300,37,2693,1607,0.86,62.63,1.0329089598846986
09-05-2020,4526,37,2797,1729,0.82,61.8,1.0525581395348838
09-06-2020,4614,37,2802,1812,0.8,60.73,1.0194432169686256
09-07-2020,4636,37,2836,1800,0.8,61.17,1.0047680970957955
09-08-2020,4727,37,2913,1814,0.78,61.62,1.0196289905090596
09-09-2020,4888,37,2947,1941,0.76,60.29,1.0340596572879204
09-10-2020,5066,37,3001,2065,0.73,59.24,1.036415711947627
09-11-2020,5252,37,3081,2171,0.7,58.66,1.0367153572838532
09-12-2020,5453,38,3114,2339,0.7,57.11,1.0382711348057883
09-13-2020,5532,38,3124,2408,0.69,56.47,1.0144874381074638
09-14-2020,5580,38,3129,2451,0.68,56.08,1.0086767895878526
09-15-2020,5768,38,3214,2554,0.66,55.72,1.0336917562724015
09-16-2020,5860,38,3220,2640,0.65,54.95,1.0159500693481276
09-17-2020,6021,39,3288,2733,0.65,54.61,1.0274744027303755
09-18-2020,6256,39,3390,2866,0.62,54.19,1.0390300614515862
09-19-2020,6546,39,3519,3027,0.6,53.76,1.0463554987212276
09-20-2020,6677,39,3548,3129,0.58,53.14,1.0200122212037885
09-21-2020,6756,39,3571,3185,0.58,52.86,1.0118316609255653
09-22-2020,6931,40,3668,3263,0.58,52.92,1.025902901124926
09-23-2020,7269,41,3888,3381,0.56,53.49,1.048766411773193
09-24-2020,7629,41,3978,3651,0.54,52.14,1.0495253817581511
09-25-2020,8048,41,4036,4012,0.51,50.15,1.0549220081268842
09-26-2020,8600,44,4098,4502,0.51,47.65,1.0685884691848906
09-27-2020,9078,44,4178,4900,0.48,46.02,1.055581395348837
09-28-2020,9343,44,4213,5130,0.47,45.09,1.0291914518616436
09-29-2020,9574,45,4329,5245,0.47,45.22,1.0247243925933853
09-30-2020,10141,48,4395,5746,0.47,43.34,1.0592228953415501
10-01-2020,10938,48,4620,6318,0.44,42.24,1.078591854846662
10-02-2020,11617,54,4756,6861,0.46,40.94,1.0620771621868714
10-03-2020,12321,54,4793,7528,0.44,38.9,1.0606008435912886
10-04-2020,13139,55,4828,8311,0.42,36.75,1.0663907150393637
10-05-2020,13492,55,4865,8627,0.41,36.06,1.026866580409468
10-06-2020,13812,55,5027,8785,0.4,36.4,1.0237177586718056
10-07-2020,14689,55,5200,9489,0.37,35.4,1.0634955111497248
10-08-2020,15726,57,5353,10373,0.36,34.04,1.0705970454081286
10-09-2020,16910,57,5452,11458,0.34,32.24,1.0752893297723516
10-10-2020,18797,61,5553,13244,0.32,29.54,1.1115907746895328
10-11-2020,19851,61,5631,14220,0.31,28.37,1.056072777570889
10-12-2020,20355,61,6031,14324,0.3,29.63,1.0253891491612512
10-13-2020,20886,61,6388,14498,0.29,30.59,1.0260869565217392
10-14-2020,22296,66,6709,15587,0.3,30.09,1.067509336397587
10-15-2020,24225,71,6926,17299,0.29,28.59,1.0865177610333692
10-16-2020,26300,71,7182,19118,0.27,27.31,1.085655314757482
10-17-2020,28268,82,7297,20971,0.29,25.81,1.074828897338403
10-18-2020,29835,88,7359,22476,0.29,24.67,1.0554337059572663
10-19-2020,30695,92,7536,23159,0.3,24.55,1.0288252052957936
10-20-2020,31400,98,8004,23396,0.31,25.49,1.0229679100830755
10-21-2020,33602,98,8404,25198,0.29,25.01,1.0701273885350318
10-22-2020,35330,115,8763,26567,0.33,24.8,1.0514255103862866
10-23-2020,37911,134,8859,29052,0.35,23.37,1.0730540617039344
10-24-2020,40801,159,9920,30881,0.39,24.31,1.0762311730104719
10-25-2020,43843,159,9960,33883,0.36,22.72,1.0745569961520551
10-26-2020,45155,165,10130,35025,0.37,22.43,1.0299249595146318
10-27-2020,46056,176,11008,35048,0.38,23.9,1.019953493522312
10-28-2020,48943,184,11799,37144,0.38,24.11,1.0626845579294772
10-29-2020,51728,200,12227,39501,0.39,23.64,1.0569029278957154
10-30-2020,55091,212,12508,42583,0.38,22.7,1.0650131456851222
10-31-2020,57664,219,12617,45047,0.38,21.88,1.0467045433918425
11-01-2020,59946,219,12798,47148,0.37,21.35,1.0395740843507215
11-02-2020,61829,219,13012,48817,0.35,21.05,1.0314116037767325
11-03-2020,63556,235,14257,49299,0.37,22.43,1.0279318766274725
11-04-2020,66772,261,15474,51298,0.39,23.17,1.0506010447479388
11-05-2020,68734,286,16426,52308,0.42,23.9,1.029383573953154
11-06-2020,71088,317,16990,54098,0.45,23.9,1.0342479704367562
11-07-2020,73667,351,18354,55313,0.48,24.91,1.0362789781679045
11-08-2020,75495,351,19481,56014,0.46,25.8,1.024814367355804
11-09-2020,76072,366,19757,56315,0.48,25.97,1.0076428902576329
11-10-2020,77123,390,21718,55405,0.51,28.16,1.0138158586602166
11-11-2020,79181,414,23247,55934,0.52,29.36,1.0266846466034776
11-12-2020,81772,464,24314,57458,0.57,29.73,1.0327224965585178
11-13-2020,83796,491,26439,57357,0.59,31.55,1.0247517487648583
11-14-2020,85567,510,29024,56543,0.6,33.92,1.02113466036565
11-15-2020,86767,510,30519,56248,0.59,35.17,1.0140240980751924
11-16-2020,87276,526,31053,56223,0.6,35.58,1.0058662855693985
11-17-2020,88602,557,33906,54696,0.63,38.27,1.0151931802557403
11-18-2020,89913,579,35924,53989,0.64,39.95,1.0147965057222184
