date,total_confirmed,total_deaths,total_recovered,total_infected,mortality_rate,recovery_rate,daily_growth_rate
03-06-2020,1,0,0,1,0,0,1
03-07-2020,1,0,0,1,0,0,1.0
03-08-2020,3,0,0,3,0,0,3.0
03-09-2020,5,0,0,5,0,0,1.6666666666666665
03-10-2020,7,0,0,7,0,0,1.4
03-11-2020,7,0,0,7,0,0,1.0
03-12-2020,10,0,0,10,0,0,1.4285714285714286
03-13-2020,21,0,0,21,0,0,2.1
03-14-2020,32,0,0,32,0,0,1.5238095238095237
03-15-2020,44,0,0,44,0,0,1.375
03-16-2020,61,0,0,61,0,0,1.3863636363636362
03-17-2020,72,0,0,72,0,0,1.180327868852459
03-18-2020,96,1,0,96,1.04,0,1.3333333333333333
03-19-2020,104,1,0,104,0.96,0,1.0833333333333333
03-20-2020,123,1,0,123,0.81,0,1.1826923076923077
03-21-2020,137,1,0,137,0.73,0,1.113821138211382
03-22-2020,178,0,7,171,0,3.93,1.2992700729927007
03-23-2020,185,0,7,178,0,3.78,1.0393258426966292
03-24-2020,204,0,7,197,0,3.43,1.1027027027027028
03-25-2020,216,0,7,209,0,3.24,1.0588235294117647
03-26-2020,226,0,2,224,0,0.88,1.0462962962962963
03-27-2020,269,0,2,267,0,0.74,1.1902654867256637
03-28-2020,292,0,2,290,0,0.68,1.0855018587360594
03-29-2020,314,0,2,312,0,0.64,1.0753424657534247
03-30-2020,336,0,7,329,0,2.08,1.070063694267516
03-31-2020,363,0,3,360,0,0.83,1.0803571428571428
04-01-2020,400,1,3,397,0.25,0.75,1.1019283746556474
04-02-2020,426,1,5,421,0.23,1.17,1.065
04-03-2020,450,1,10,440,0.22,2.22,1.056338028169014
04-04-2020,471,1,10,461,0.21,2.12,1.0466666666666666
04-05-2020,485,1,10,475,0.21,2.06,1.029723991507431
04-06-2020,534,2,8,526,0.37,1.5,1.1010309278350516
04-07-2020,581,2,13,568,0.34,2.24,1.0880149812734083
04-08-2020,682,2,16,666,0.29,2.35,1.1738382099827882
04-09-2020,701,2,23,678,0.29,3.28,1.0278592375366569
04-10-2020,715,2,23,692,0.28,3.22,1.0199714693295292
04-11-2020,728,2,23,705,0.27,3.16,1.018181818181818
04-12-2020,742,2,23,719,0.27,3.1,1.0192307692307692
04-13-2020,769,2,107,662,0.26,13.91,1.036388140161725
04-14-2020,835,2,113,722,0.24,13.53,1.0858257477243174
04-15-2020,863,6,151,712,0.7,17.5,1.0335329341317365
04-16-2020,977,8,167,810,0.82,17.09,1.1320973348783314
04-17-2020,1049,9,175,874,0.86,16.68,1.0736949846468782
04-18-2020,1089,11,213,876,1.01,19.56,1.0381315538608198
04-19-2020,1161,12,229,932,1.03,19.72,1.0661157024793388
04-20-2020,1173,13,251,922,1.11,21.4,1.0103359173126616
04-21-2020,1199,14,258,941,1.17,21.52,1.0221653878942882
04-22-2020,1244,14,284,960,1.13,22.83,1.0375312760633861
04-23-2020,1325,15,288,1037,1.13,21.74,1.065112540192926
04-24-2020,1360,17,355,1005,1.25,26.1,1.0264150943396226
04-25-2020,1373,17,386,987,1.24,28.11,1.0095588235294117
04-26-2020,1379,18,394,985,1.31,28.57,1.0043699927166787
04-27-2020,1381,18,403,978,1.3,29.18,1.0014503263234227
04-28-2020,1384,20,423,961,1.45,30.56,1.002172338884866
04-29-2020,1391,22,484,907,1.58,34.8,1.005057803468208
04-30-2020,1396,23,524,872,1.65,37.54,1.0035945363048167
05-01-2020,1403,23,558,845,1.64,39.77,1.0050143266475644
05-02-2020,1407,24,608,799,1.71,43.21,1.0028510334996437
05-03-2020,1408,24,619,789,1.7,43.96,1.0007107320540156
05-04-2020,1413,25,643,770,1.77,45.51,1.0035511363636365
05-05-2020,1421,25,741,680,1.76,52.15,1.005661712668082
05-06-2020,1429,25,762,667,1.75,53.32,1.0056298381421533
05-07-2020,1445,26,806,639,1.8,55.78,1.0111966410076978
05-08-2020,1455,26,905,550,1.79,62.2,1.0069204152249136
05-09-2020,1455,26,919,536,1.79,63.16,1.0
05-10-2020,1457,26,941,516,1.78,64.58,1.0013745704467354
05-11-2020,1457,26,959,498,1.78,65.82,1.0
05-12-2020,1465,27,983,482,1.84,67.1,1.005490734385724
05-13-2020,1469,27,1060,409,1.84,72.16,1.0027303754266212
05-14-2020,1477,27,1112,365,1.83,75.29,1.0054458815520761
05-15-2020,1480,27,1131,349,1.82,76.42,1.002031144211239
05-16-2020,1493,28,1151,342,1.88,77.09,1.0087837837837839
05-17-2020,1494,28,1163,331,1.87,77.84,1.000669792364367
05-18-2020,1495,28,1185,310,1.87,79.26,1.000669344042838
05-19-2020,1495,28,1192,303,1.87,79.73,1.0
05-20-2020,1496,28,1231,265,1.87,82.29,1.0006688963210701
05-21-2020,1502,28,1245,257,1.86,82.89,1.0040106951871657
05-22-2020,1503,28,1256,247,1.86,83.57,1.0006657789613849
05-23-2020,1504,28,1280,224,1.86,85.11,1.0006653359946773
05-24-2020,1509,28,1301,208,1.86,86.22,1.0033244680851063
05-25-2020,1511,28,1307,204,1.85,86.5,1.001325381047051
05-26-2020,1513,28,1322,191,1.85,87.38,1.00132362673726
05-27-2020,1515,28,1327,188,1.85,87.59,1.0013218770654329
05-28-2020,1520,28,1332,188,1.84,87.63,1.0033003300330032
05-29-2020,1520,28,1338,182,1.84,88.03,1.0
05-30-2020,1521,28,1356,165,1.84,89.15,1.000657894736842
05-31-2020,1521,28,1366,155,1.84,89.81,1.0
06-01-2020,1522,28,1368,154,1.84,89.88,1.0006574621959237
06-02-2020,1522,28,1372,150,1.84,90.14,1.0
06-03-2020,1525,28,1375,150,1.84,90.16,1.0019710906701709
06-04-2020,1526,28,1376,150,1.83,90.17,1.0006557377049181
06-05-2020,1526,28,1379,147,1.83,90.37,1.0
06-06-2020,1528,28,1379,149,1.83,90.25,1.001310615989515
06-07-2020,1528,28,1389,139,1.83,90.9,1.0
06-08-2020,1530,28,1396,134,1.83,91.24,1.0013089005235603
06-09-2020,1531,28,1402,129,1.83,91.57,1.0006535947712418
06-10-2020,1533,28,1404,129,1.83,91.59,1.001306335728282
06-11-2020,1541,28,1409,132,1.82,91.43,1.005218525766471
06-12-2020,1542,28,1409,133,1.82,91.37,1.00064892926671
06-13-2020,1545,28,1410,135,1.81,91.26,1.0019455252918288
06-14-2020,1548,28,1410,138,1.81,91.09,1.0019417475728156
06-15-2020,1552,28,1410,142,1.8,90.85,1.0025839793281655
06-16-2020,1552,28,1426,126,1.8,91.88,1.0
06-17-2020,1561,28,1437,124,1.79,92.06,1.005798969072165
06-18-2020,1562,28,1443,119,1.79,92.38,1.0006406149903908
06-19-2020,1576,28,1447,129,1.78,91.81,1.0089628681177978
06-20-2020,1586,28,1447,139,1.77,91.24,1.0063451776649746
06-21-2020,1587,28,1447,140,1.76,91.18,1.0006305170239596
06-22-2020,1588,28,1447,141,1.76,91.12,1.0006301197227474
06-23-2020,1589,28,1448,141,1.76,91.13,1.0006297229219143
06-24-2020,1607,28,1448,159,1.74,90.11,1.0113278791692888
06-25-2020,1630,28,1452,178,1.72,89.08,1.0143123833229621
06-26-2020,1643,28,1455,188,1.7,88.56,1.0079754601226993
06-27-2020,1657,28,1455,202,1.69,87.81,1.008520998174072
06-28-2020,1664,28,1461,203,1.68,87.8,1.0042245021122511
06-29-2020,1665,28,1464,201,1.68,87.93,1.0006009615384615
06-30-2020,1667,28,1464,203,1.68,87.82,1.0012012012012013
07-01-2020,1687,28,1466,221,1.66,86.9,1.011997600479904
07-02-2020,1700,28,1466,234,1.65,86.24,1.007705986959099
07-03-2020,1720,28,1466,254,1.63,85.23,1.011764705882353
07-04-2020,1749,28,1466,283,1.6,83.82,1.0168604651162791
07-05-2020,1764,28,1466,298,1.59,83.11,1.0085763293310464
07-06-2020,1765,28,1466,299,1.59,83.06,1.0005668934240364
07-07-2020,1767,28,1473,294,1.58,83.36,1.0011331444759206
07-08-2020,1798,28,1473,325,1.56,81.92,1.0175438596491229
07-09-2020,1851,28,1477,374,1.51,79.79,1.0294771968854282
07-10-2020,1870,28,1481,389,1.5,79.2,1.010264721772015
07-11-2020,1893,28,1493,400,1.48,78.87,1.0122994652406416
07-12-2020,1901,28,1493,408,1.47,78.54,1.0042260961436873
07-13-2020,1902,28,1493,409,1.47,78.5,1.0005260389268806
07-14-2020,1908,28,1493,415,1.47,78.25,1.003154574132492
07-15-2020,1927,28,1507,420,1.45,78.2,1.009958071278826
07-16-2020,1951,28,1514,437,1.44,77.6,1.0124545926310327
07-17-2020,1965,28,1523,442,1.42,77.51,1.0071758072783188
07-18-2020,1976,28,1523,453,1.42,77.07,1.0055979643765904
07-19-2020,1979,28,1530,449,1.41,77.31,1.0015182186234817
07-20-2020,1980,28,1538,442,1.41,77.68,1.0005053057099544
07-21-2020,2021,28,1538,483,1.39,76.1,1.0207070707070707
07-22-2020,2058,28,1556,502,1.36,75.61,1.0183077684314696
07-23-2020,2089,28,1556,533,1.34,74.49,1.0150631681243927
07-24-2020,2118,28,1577,541,1.32,74.46,1.0138822403063668
07-25-2020,2141,28,1577,564,1.31,73.66,1.0108593012275733
07-26-2020,2179,28,1577,602,1.28,72.37,1.0177487155534797
07-27-2020,2181,28,1616,565,1.28,74.09,1.0009178522257915
07-28-2020,2204,28,1644,560,1.27,74.59,1.0105456212746446
07-29-2020,2245,28,1660,585,1.25,73.94,1.0186025408348458
07-30-2020,2265,28,1675,590,1.24,73.95,1.0089086859688197
07-31-2020,2292,29,1695,597,1.27,73.95,1.0119205298013245
08-01-2020,2337,29,1742,595,1.24,74.54,1.0196335078534031
08-02-2020,2344,29,1742,602,1.24,74.32,1.002995293110826
08-03-2020,2354,29,1746,608,1.23,74.17,1.0042662116040955
08-04-2020,2368,29,1771,597,1.22,74.79,1.005947323704333
08-05-2020,2417,29,1777,640,1.2,73.52,1.0206925675675675
08-06-2020,2480,29,1824,656,1.17,73.55,1.0260653702937526
08-07-2020,2523,31,1846,677,1.23,73.17,1.0173387096774194
08-08-2020,2566,31,1861,705,1.21,72.53,1.0170432025366627
08-09-2020,2596,31,1864,732,1.19,71.8,1.0116913484021823
08-10-2020,2599,31,1866,733,1.19,71.8,1.0011556240369799
08-11-2020,2615,31,1874,741,1.19,71.66,1.006156213928434
08-12-2020,2690,31,1884,806,1.15,70.04,1.02868068833652
08-13-2020,2739,31,1939,800,1.13,70.79,1.0182156133828997
08-14-2020,2801,31,1944,857,1.11,69.4,1.022635998539613
08-15-2020,2855,31,1969,886,1.09,68.97,1.0192788289896466
08-16-2020,2902,31,1969,933,1.07,67.85,1.01646234676007
08-17-2020,2907,31,1969,938,1.07,67.73,1.001722949689869
08-18-2020,2922,31,1980,942,1.06,67.76,1.0051599587203301
08-19-2020,3022,33,1997,1025,1.09,66.08,1.0342231348391513
08-20-2020,3102,33,2014,1088,1.06,64.93,1.026472534745202
08-21-2020,3225,33,2045,1180,1.02,63.41,1.039651837524178
08-22-2020,3316,33,2147,1169,1.0,64.75,1.0282170542635658
08-23-2020,3356,33,2148,1208,0.98,64.0,1.0120627261761157
08-24-2020,3424,33,2153,1271,0.96,62.88,1.0202622169249107
08-25-2020,3452,33,2167,1285,0.96,62.78,1.0081775700934579
08-26-2020,3536,33,2192,1344,0.93,61.99,1.0243337195828506
08-27-2020,3626,33,2206,1420,0.91,60.84,1.0254524886877827
08-28-2020,3728,33,2225,1503,0.89,59.68,1.0281301709873139
08-29-2020,3842,33,2254,1588,0.86,58.67,1.030579399141631
08-30-2020,3876,33,2278,1598,0.85,58.77,1.008849557522124
08-31-2020,3917,33,2377,1540,0.84,60.68,1.010577915376677
09-01-2020,3989,33,2478,1511,0.83,62.12,1.018381414347715
09-02-2020,4042,33,2523,1519,0.82,62.42,1.0132865379794436
09-03-2020,4163,37,2617,1546,0.89,62.86,1.0299356754082138
09-04-2020,4300,37,2693,1607,0.86,62.63,1.0329089598846986
09-05-2020,4526,37,2797,1729,0.82,61.8,1.0525581395348838
09-06-2020,4614,37,2802,1812,0.8,60.73,1.0194432169686256
09-07-2020,4636,37,2836,1800,0.8,61.17,1.0047680970957955
09-08-2020,4727,37,2913,1814,0.78,61.62,1.0196289905090596
09-09-2020,4888,37,2947,1941,0.76,60.29,1.0340596572879204
09-10-2020,5066,37,3001,2065,0.73,59.24,1.036415711947627
09-11-2020,5252,37,3081,2171,0.7,58.66,1.0367153572838532
09-12-2020,5453,38,3114,2339,0.7,57.11,1.0382711348057883
09-13-2020,5532,38,3124,2408,0.69,56.47,1.0144874381074638
09-14-2020,5580,38,3129,2451,0.68,56.08,1.0086767895878526
09-15-2020,5768,38,3214,2554,0.66,55.72,1.0336917562724015
09-16-2020,5860,38,3220,2640,0.65,54.95,1.0159500693481276
09-17-2020,6021,39,3288,2733,0.65,54.61,1.0274744027303755
09-18-2020,6256,39,3390,2866,0.62,54.19,1.0390300614515862
09-19-2020,6546,39,3519,3027,0.6,53.76,1.0463554987212276
09-20-2020,6677,39,3548,3129,0.58,53.14,1.0200122212037885
09-21-2020,6756,39,3571,3185,0.58,52.86,1.0118316609255653
09-22-2020,6931,40,3668,3263,0.58,52.92,1.025902901124926
09-23-2020,7269,41,3888,3381,0.56,53.49,1.048766411773193
09-24-2020,7629,41,3978,3651,0.54,52.14,1.0495253817581511
09-25-2020,8048,41,4036,4012,0.51,50.15,1.0549220081268842
09-26-2020,8600,44,4098,4502,0.51,47.65,1.0685884691848906
09-27-2020,9078,44,4178,4900,0.48,46.02,1.055581395348837
09-28-2020,9343,44,4213,5130,0.47,45.09,1.0291914518616436
09-29-2020,9574,45,4329,5245,0.47,45.22,1.0247243925933853
09-30-2020,10141,48,4395,5746,0.47,43.34,1.0592228953415501
10-01-2020,10938,48,4620,6318,0.44,42.24,1.078591854846662
10-02-2020,11617,54,4756,6861,0.46,40.94,1.0620771621868714
10-03-2020,12321,54,4793,7528,0.44,38.9,1.0606008435912886
10-04-2020,13139,55,4828,8311,0.42,36.75,1.0663907150393637
10-05-2020,13492,55,4865,8627,0.41,36.06,1.026866580409468
10-06-2020,13812,55,5027,8785,0.4,36.4,1.0237177586718056
10-07-2020,14689,55,5200,9489,0.37,35.4,1.0634955111497248
10-08-2020,15726,57,5353,10373,0.36,34.04,1.0705970454081286
10-09-2020,16910,57,5452,11458,0.34,32.24,1.0752893297723516
10-10-2020,18797,61,5553,13244,0.32,29.54,1.1115907746895328
10-11-2020,19851,61,5631,14220,0.31,28.37,1.056072777570889
10-12-2020,20355,61,6031,14324,0.3,29.63,1.0253891491612512
10-13-2020,20926,61,6388,14538,0.29,30.53,1.0280520756570868
10-14-2020,22420,66,6709,15711,0.29,29.92,1.071394437541814
10-15-2020,24380,71,6926,17454,0.29,28.41,1.087421944692239
10-16-2020,26491,71,7182,19309,0.27,27.11,1.0865873666940116
10-17-2020,28486,82,7297,21189,0.29,25.62,1.0753085953720132
10-18-2020,30053,88,7359,22694,0.29,24.49,1.0550094783402373
10-19-2020,30913,92,7536,23377,0.3,24.38,1.028616111536286
10-20-2020,31687,98,8004,23683,0.31,25.26,1.0250380098987482
10-21-2020,33927,98,8404,25523,0.29,24.77,1.0706914507526746
10-22-2020,35703,115,8763,26940,0.32,24.54,1.052347687682377
10-23-2020,38425,134,8859,29566,0.35,23.06,1.0762400918690307
10-24-2020,41434,159,9920,31514,0.38,23.94,1.0783083929733246
10-25-2020,44541,159,9960,34581,0.36,22.36,1.074986725877299
10-26-2020,45893,165,10130,35763,0.36,22.07,1.0303540558137447
10-27-2020,47025,176,11008,36017,0.37,23.41,1.024666071078378
10-28-2020,50146,184,11799,38347,0.37,23.53,1.0663689526847422
10-29-2020,53156,200,12227,40929,0.38,23.0,1.0600247277948391
10-30-2020,56758,212,12508,44250,0.37,22.04,1.0677628113477313
10-31-2020,59823,219,12617,47206,0.37,21.09,1.0540011980689947
11-01-2020,63080,219,12798,50282,0.35,20.29,1.0544439429650803
11-02-2020,65339,219,13012,52327,0.34,19.91,1.0358116677235256
11-03-2020,68397,235,14257,54140,0.34,20.84,1.046802063086365
11-04-2020,71711,261,15474,56237,0.36,21.58,1.0484524175036918
11-05-2020,73755,286,16426,57329,0.39,22.27,1.0285032979598667
11-06-2020,76249,317,16990,59259,0.42,22.28,1.0338146566334485
11-07-2020,79155,351,18354,60801,0.44,23.19,1.0381119752390195
11-08-2020,81422,351,19481,61941,0.43,23.93,1.0286400101067525
11-09-2020,82142,366,19757,62385,0.45,24.05,1.0088428188941563
11-10-2020,84347,390,21718,62629,0.46,25.75,1.0268437583696526
11-11-2020,86545,414,23247,63298,0.48,26.86,1.0260590181037856
11-12-2020,89237,464,24314,64923,0.52,27.25,1.031105205384482
11-13-2020,91434,491,26439,64995,0.54,28.92,1.024619832580656
11-14-2020,93363,510,29024,64339,0.55,31.09,1.0210971848546493
11-15-2020,94662,510,30519,64143,0.54,32.24,1.0139134346582694
11-16-2020,95204,526,31053,64151,0.55,32.62,1.0057256343622574
11-17-2020,96816,557,33906,62910,0.58,35.02,1.0169320616780808
11-18-2020,98351,579,35924,62427,0.59,36.53,1.0158548173855562
11-19-2020,100458,579,38695,61763,0.58,38.52,1.021423269717644
11-20-2020,103046,614,40816,62230,0.6,39.61,1.0257620099942264
11-21-2020,105518,644,43188,62330,0.61,40.93,1.0239892863381403
11-22-2020,106824,671,45883,60941,0.63,42.95,1.012377035197786
11-23-2020,107112,693,47933,59179,0.65,44.75,1.0026960233655358
11-24-2020,109017,709,50738,58279,0.65,46.54,1.0177851221151692
11-25-2020,111722,732,53547,58175,0.66,47.93,1.0248126438995753
11-26-2020,114408,749,56378,58030,0.65,49.28,1.0240418180841733
11-27-2020,117124,771,59285,57839,0.66,50.62,1.0237395986294664
11-28-2020,119438,798,62094,57344,0.67,51.99,1.0197568389057752
11-29-2020,120971,816,64197,56774,0.67,53.07,1.0128351111036689
11-30-2020,121347,839,66041,55306,0.69,54.42,1.0031081829529391
12-01-2020,124318,868,68859,55459,0.7,55.39,1.024483505978722
12-02-2020,127958,898,71738,56220,0.7,56.06,1.0292797503177336
12-03-2020,131603,930,74273,57330,0.71,56.44,1.0284859094390346
12-04-2020,135061,957,77142,57919,0.71,57.12,1.0262759967477946
12-05-2020,138391,981,79956,58435,0.71,57.78,1.0246555260215755
12-06-2020,140027,996,82666,57361,0.71,59.04,1.0118215779927886
12-07-2020,140708,1018,84850,55858,0.72,60.3,1.0048633477829276
12-08-2020,144821,1046,87433,57388,0.72,60.37,1.029230747363334
12-09-2020,150345,1084,89769,60576,0.72,59.71,1.038143639389315
12-10-2020,155776,1104,91455,64321,0.71,58.71,1.0361235824270845
12-11-2020,161050,1122,93533,67517,0.7,58.08,1.0338563064913722
12-12-2020,167317,1148,95416,71901,0.69,57.03,1.038913380937597
12-13-2020,170507,1175,97068,73439,0.69,56.93,1.019065606005367
12-14-2020,171111,1205,98585,72526,0.7,57.61,1.00354237655932
12-15-2020,176317,1251,100303,76014,0.71,56.89,1.0304246950809708
12-16-2020,184020,1309,101584,82436,0.71,55.2,1.0436883567665058
12-17-2020,190616,1378,102737,87879,0.72,53.9,1.0358439300076079
12-18-2020,198451,1440,104560,93891,0.73,52.69,1.0411035799723003
12-19-2020,204973,1510,106361,98612,0.74,51.89,1.0328645358300035
12-20-2020,208055,1555,107828,100227,0.75,51.83,1.0150361267093715
12-21-2020,209770,1618,109807,99963,0.77,52.35,1.0082430126649202
12-22-2020,219523,1618,110565,108958,0.74,50.37,1.0464937789007007
12-23-2020,228738,1686,112627,116111,0.74,49.24,1.0419773782246051
12-24-2020,236092,1732,114267,121825,0.73,48.4,1.0321503204539693
12-25-2020,241156,1732,115663,125493,0.72,47.96,1.021449265540552
12-26-2020,242338,1732,116948,125390,0.71,48.26,1.004901391630314
12-27-2020,243424,1773,119086,124338,0.73,48.92,1.0044813442382128
12-28-2020,244297,1879,120410,123887,0.77,49.29,1.003586334954647
12-29-2020,252945,1983,121760,131185,0.78,48.14,1.0353995341735673
12-30-2020,262688,2065,124427,138261,0.79,47.37,1.0385182549566112
12-31-2020,274603,2138,125971,148632,0.78,45.87,1.0453579912291389
01-01-2021,285079,2250,127190,157889,0.79,44.62,1.038149619632706
01-02-2021,287405,2250,128285,159120,0.78,44.64,1.0081591418519078
01-03-2021,289150,2317,129994,159156,0.8,44.96,1.006071571475792
01-04-2021,290058,2521,130897,159161,0.87,45.13,1.0031402386304686
01-05-2021,300405,2603,132852,167553,0.87,44.22,1.0356721759096457
01-06-2021,311485,2657,135760,175725,0.85,43.58,1.036883540553586
01-07-2021,314650,2717,138383,176267,0.86,43.98,1.0101610029375412
01-08-2021,322941,2788,141490,181451,0.86,43.81,1.026349912601303
01-09-2021,330944,2836,144612,186332,0.86,43.7,1.0247816164562566
01-10-2021,335804,2918,147275,188529,0.87,43.86,1.0146852639721524
01-11-2021,337589,3007,150239,187350,0.89,44.5,1.0053156007671142
01-12-2021,343293,3102,153755,189538,0.9,44.79,1.0168962851277736
01-13-2021,349898,3163,157028,192870,0.9,44.88,1.0192401243252849
01-14-2021,355451,3260,160401,195050,0.92,45.13,1.0158703393560409
01-15-2021,360473,3362,163323,197150,0.93,45.31,1.0141285296707563
01-16-2021,364694,3417,166555,198139,0.94,45.67,1.011709614867133
01-17-2021,366395,3474,168915,197480,0.95,46.1,1.0046641842201955
01-18-2021,369089,3526,171092,197997,0.96,46.36,1.0073527204246784
01-19-2021,374383,3637,173761,200622,0.97,46.41,1.0143434239438185
01-20-2021,379537,3737,176864,202673,0.98,46.6,1.0137666507293333
01-21-2021,384329,3801,181129,203200,0.99,47.13,1.0126259099903303
01-22-2021,389217,3894,183942,205275,1.0,47.26,1.0127182700238597
01-23-2021,393609,3965,186683,206926,1.01,47.43,1.0112841936503287
01-24-2021,402029,4068,189959,212070,1.01,47.25,1.0213917872812868
01-25-2021,406373,4068,193380,212993,1.0,47.59,1.0108051906703248
01-26-2021,410701,4260,197191,213510,1.04,48.01,1.0106503138741993
01-27-2021,416143,4361,202148,213995,1.05,48.58,1.0132505155818954
01-28-2021,419905,4411,205247,214658,1.05,48.88,1.0090401616751934
01-29-2021,424576,4495,208406,216170,1.06,49.09,1.0111239447017777
01-30-2021,429474,4565,212271,217203,1.06,49.43,1.011536214953271
01-31-2021,436016,4642,216052,219964,1.06,49.55,1.0152325868387841
02-01-2021,439325,4711,218923,220402,1.07,49.83,1.0075891710395948
02-02-2021,444562,4784,222642,221920,1.08,50.08,1.0119205599499232
02-03-2021,451043,4889,226471,224572,1.08,50.21,1.014578394014783
02-04-2021,455693,4976,230456,225237,1.09,50.57,1.010309438346233
02-05-2021,461246,5050,234371,226875,1.09,50.81,1.012185835639345
02-06-2021,466535,5135,238221,228314,1.1,51.06,1.0114667661074568
02-07-2021,473575,5199,241686,231889,1.1,51.03,1.015089971813476
02-08-2021,477647,5271,245702,231945,1.1,51.44,1.008598426859526
02-09-2021,483002,5382,248386,234616,1.11,51.43,1.0112112082772424
02-10-2021,489218,5502,251618,237600,1.12,51.43,1.0128695119274869
02-11-2021,494688,5629,253518,241170,1.14,51.25,1.0111811094440515
02-12-2021,499593,5733,255300,244293,1.15,51.1,1.009915340578304
02-13-2021,505266,5812,255300,249966,1.15,50.53,1.0113552431679387
02-14-2021,511547,5885,255300,256247,1.15,49.91,1.0124310759085313
02-15-2021,515038,5952,255300,259738,1.16,49.57,1.0068243973672018
02-16-2021,519763,6063,255300,264463,1.17,49.12,1.0091740803591192
02-17-2021,525692,6168,255300,270392,1.17,48.56,1.0114071220921843
02-18-2021,531043,6271,255300,275743,1.18,48.08,1.010178964108261
02-19-2021,536173,6350,255300,280873,1.18,47.62,1.0096602346702621
02-20-2021,542452,6424,255300,287152,1.18,47.06,1.0117107724559051
02-21-2021,549434,6505,255300,294134,1.18,46.47,1.0128711849159004
02-22-2021,552972,6577,255300,297672,1.19,46.17,1.0064393539533412
02-23-2021,558407,6671,255300,303107,1.19,45.72,1.0098287074209906
02-24-2021,564839,6775,255300,309539,1.2,45.2,1.0115184802482777
02-25-2021,570287,6859,255300,314987,1.2,44.77,1.009645226338833
02-26-2021,575542,6966,255300,320242,1.21,44.36,1.0092146585841866
02-27-2021,581724,7075,255300,326424,1.22,43.89,1.0107411796185162
02-28-2021,588671,7189,255300,333371,1.22,43.37,1.0119420893757176
03-01-2021,592135,7270,255300,336835,1.23,43.12,1.0058844413942594
03-02-2021,597397,7388,255300,342097,1.24,42.74,1.0088864870342067
03-03-2021,603500,7489,255300,348200,1.24,42.3,1.0102159870237044
03-04-2021,608790,7560,255300,353490,1.24,41.94,1.0087655343827673
03-05-2021,613613,7665,255300,358313,1.25,41.61,1.0079222720478327
03-06-2021,618978,7739,255300,363678,1.25,41.25,1.008743295855857
03-07-2021,624188,7836,255300,368888,1.26,40.9,1.0084171004462195
03-08-2021,626882,7921,255300,371582,1.26,40.73,1.0043160073567579
03-09-2021,631700,8037,255300,376400,1.27,40.41,1.0076856569497927
03-10-2021,637344,8146,255300,382044,1.28,40.06,1.0089346208643344
03-11-2021,641295,8244,255300,385995,1.29,39.81,1.0061991640307275
03-12-2021,645457,8346,255300,390157,1.29,39.55,1.0064899929049813
03-13-2021,650209,8440,255300,394909,1.3,39.26,1.0073622255239312
03-14-2021,654912,8528,255300,399612,1.3,38.98,1.0072330589087508
03-15-2021,657214,8605,255300,401914,1.31,38.85,1.0035149760578521
03-16-2021,661025,8669,255300,405725,1.31,38.62,1.0057987200516119
03-17-2021,665746,8738,255300,410446,1.31,38.35,1.0071419386558753
03-18-2021,669337,8814,255300,414037,1.32,38.14,1.0053939490436292
03-19-2021,672631,8894,255300,417331,1.32,37.96,1.0049212877817901
03-20-2021,676460,8978,255300,421160,1.33,37.74,1.0056925714098814
03-21-2021,680076,9044,255300,424776,1.33,37.54,1.0053454749726518
03-22-2021,682042,9104,255300,426742,1.33,37.43,1.002890853375211
03-23-2021,685094,9190,255300,429794,1.34,37.26,1.0044747977397286
03-24-2021,688587,9261,255300,433287,1.34,37.08,1.0050985704151547
03-25-2021,691648,9313,255300,436348,1.35,36.91,1.0044453351573586
03-26-2021,694284,9373,255300,438984,1.35,36.77,1.0038111871934856
03-27-2021,697479,9426,255300,442179,1.35,36.6,1.004601863214477
03-28-2021,700607,9496,255300,445307,1.36,36.44,1.0044847228375335
03-29-2021,702117,9542,255300,446817,1.36,36.36,1.002155273926752
03-30-2021,704811,9624,255300,449511,1.37,36.22,1.0038369673430496
03-31-2021,707876,9719,255300,452576,1.37,36.07,1.004348683547788
04-01-2021,710422,9790,255300,455122,1.38,35.94,1.0035966751238918
04-02-2021,713050,9877,255300,457750,1.39,35.8,1.0036992097654633
04-03-2021,714421,9948,255300,459121,1.39,35.74,1.0019227263165276
04-04-2021,716997,10025,255300,461697,1.4,35.61,1.0036057170771855
04-05-2021,717704,10094,255300,462404,1.41,35.57,1.0009860571243674
04-06-2021,718676,10094,255300,463376,1.4,35.52,1.0013543187720844
04-07-2021,721316,10243,255300,466016,1.42,35.39,1.00367342168098
04-08-2021,723860,10322,255300,468560,1.43,35.27,1.003526886967709
04-09-2021,725589,10411,255300,470289,1.43,35.19,1.0023885834277346
04-10-2021,727606,10487,255300,472306,1.44,35.09,1.0027798106090362
04-11-2021,729587,10565,255300,474287,1.45,34.99,1.0027226273560141
04-12-2021,730428,10630,255300,475128,1.46,34.95,1.0011527069424209
04-13-2021,732212,10716,255300,476912,1.46,34.87,1.0024424036318433
04-14-2021,733974,10798,255300,478674,1.47,34.78,1.0024064068876226
04-15-2021,735497,10877,255300,480197,1.48,34.71,1.002075005381662
04-16-2021,736807,10970,255300,481507,1.49,34.65,1.0017811085565271
04-17-2021,738393,11043,255300,483093,1.5,34.58,1.0021525311241615
04-18-2021,740038,11106,255300,484738,1.5,34.5,1.002227810935369
04-19-2021,740766,11172,255300,485466,1.51,34.46,1.0009837332677511
04-20-2021,742236,11244,255300,486936,1.51,34.4,1.0019844323308575
04-21-2021,743647,11304,255300,488347,1.52,34.33,1.0019010126159336
04-22-2021,744982,11357,255300,489682,1.52,34.27,1.0017952065966782
04-23-2021,746030,11405,255300,490730,1.53,34.22,1.0014067453978754
04-24-2021,747566,11458,255300,492266,1.53,34.15,1.0020588984357197
04-25-2021,748935,11495,255300,493635,1.53,34.09,1.001831276435793
04-26-2021,749627,11531,255300,494327,1.54,34.06,1.0009239787164441
04-27-2021,750817,11572,255300,495517,1.54,34.0,1.001587456161531
04-28-2021,752009,11611,255300,496709,1.54,33.95,1.0015876039034812
04-29-2021,753075,11647,255300,497775,1.55,33.9,1.0014175362262951
04-30-2021,754078,11684,255300,498778,1.55,33.86,1.001331872655446
05-01-2021,755233,11732,255300,499933,1.55,33.8,1.001531671789921
05-02-2021,756249,11766,255300,500949,1.56,33.76,1.0013452801982965
05-03-2021,756876,11807,255300,501576,1.56,33.73,1.0008290920054108
05-04-2021,757806,11855,255300,502506,1.56,33.69,1.0012287349579059
05-05-2021,758896,11886,255300,503596,1.57,33.64,1.0014383628527619
05-06-2021,759611,11920,255300,504311,1.57,33.61,1.0009421580822668
05-07-2021,760362,11946,255300,505062,1.57,33.58,1.0009886639345664
05-08-2021,761194,11990,255300,505894,1.58,33.54,1.001094215649914
05-09-2021,761546,12019,255300,506246,1.58,33.52,1.0004624313906836
05-10-2021,762257,12051,255300,506957,1.58,33.49,1.0009336271216709
05-11-2021,763041,12077,255300,507741,1.58,33.46,1.001028524500267
05-12-2021,763714,12096,255300,508414,1.58,33.43,1.0008819971666005
05-13-2021,764321,12135,255300,509021,1.59,33.4,1.0007948001476992
05-14-2021,764881,12168,255300,509581,1.59,33.38,1.000732676454003
05-15-2021,765492,12203,255300,510192,1.59,33.35,1.0007988170708908
05-16-2021,765867,12224,255300,510567,1.6,33.33,1.0004898810176983
05-17-2021,766253,12238,255300,510953,1.6,33.32,1.000504003958912
05-18-2021,766804,12248,255300,511504,1.6,33.29,1.000719083644697
05-19-2021,767276,12262,255300,511976,1.6,33.27,1.0006155419116227
05-20-2021,767731,12272,255300,512431,1.6,33.25,1.0005930069492595
05-21-2021,768041,12280,255300,512741,1.6,33.24,1.0004037872640288
05-22-2021,768439,12286,255300,513139,1.6,33.22,1.0005182015022636
05-23-2021,768747,12292,255300,513447,1.6,33.21,1.0004008125563644
05-24-2021,768955,12296,255300,513655,1.6,33.2,1.0002705701615746
05-25-2021,769351,12301,255300,514051,1.6,33.18,1.000514984621987
05-26-2021,769748,12312,255300,514448,1.6,33.17,1.0005160193461762
05-27-2021,770058,12320,255300,514758,1.6,33.15,1.0004027292048827
05-28-2021,770311,12333,255300,515011,1.6,33.14,1.0003285466808993
05-29-2021,770629,12333,255300,515329,1.6,33.13,1.0004128202764857
05-30-2021,770851,12339,255300,515551,1.6,33.12,1.000288076363594
05-31-2021,771008,12343,255300,515708,1.6,33.11,1.0002036710077564
06-01-2021,771363,12353,255300,516063,1.6,33.1,1.0004604362081846
06-02-2021,771621,12366,255300,516321,1.6,33.09,1.0003344728746388
06-03-2021,771879,12375,255300,516579,1.6,33.08,1.0003343610399407
06-04-2021,772106,12382,255300,516806,1.6,33.07,1.0002940875448094
06-05-2021,772358,12395,255300,517058,1.6,33.05,1.0003263800566244
06-06-2021,772528,12404,255300,517228,1.61,33.05,1.0002201051843833
06-07-2021,772630,12414,255300,517330,1.61,33.04,1.0001320340492512
06-08-2021,772873,12423,255300,517573,1.61,33.03,1.0003145101795168
06-09-2021,773114,12430,255300,517814,1.61,33.02,1.0003118235466888
06-10-2021,773280,12433,255300,517980,1.61,33.02,1.0002147160703336
06-11-2021,773436,12433,255300,518136,1.61,33.01,1.0002017380509
06-12-2021,773611,12436,255300,518311,1.61,33.0,1.0002262630650758
06-13-2021,773710,12439,255300,518410,1.61,33.0,1.000127971293066
06-14-2021,773779,12441,255300,518479,1.61,32.99,1.0000891807007795
06-15-2021,773906,12446,255300,518606,1.61,32.99,1.0001641295512027
06-16-2021,774015,12456,255300,518715,1.61,32.98,1.0001408439784676
06-17-2021,774115,12464,255300,518815,1.61,32.98,1.000129196462601
06-18-2021,774196,12478,255300,518896,1.61,32.98,1.0001046356161551
06-19-2021,774299,12478,255300,518999,1.61,32.97,1.0001330412453693
06-20-2021,774350,12478,255300,519050,1.61,32.97,1.000065866028498
06-21-2021,774392,12496,255300,519092,1.61,32.97,1.0000542390391942
06-22-2021,774510,12502,255300,519210,1.61,32.96,1.0001523776072068
06-23-2021,774575,12502,255300,519275,1.61,32.96,1.0000839240293864
06-24-2021,774642,12502,255300,519342,1.61,32.96,1.000086499047865
06-25-2021,774712,12505,255300,519412,1.61,32.95,1.0000903643231325
06-26-2021,774786,12505,255300,519486,1.61,32.95,1.0000955193671972
06-27-2021,774838,12505,255300,519538,1.61,32.95,1.0000671153066782
06-28-2021,774875,12509,255300,519575,1.61,32.95,1.0000477519171749
06-29-2021,774954,12510,255300,519654,1.61,32.94,1.0001019519277303
06-30-2021,775011,12510,255300,519711,1.61,32.94,1.0000735527528086
07-01-2021,775066,12511,255300,519766,1.61,32.94,1.0000709667346657
07-02-2021,775094,12511,255300,519794,1.61,32.94,1.000036125955725
07-03-2021,775128,12513,255300,519828,1.61,32.94,1.0000438656472634
07-04-2021,775157,12513,255300,519857,1.61,32.94,1.0000374131756304
07-05-2021,775169,12513,255300,519869,1.61,32.93,1.0000154807348705
07-06-2021,775193,12514,255300,519893,1.61,32.93,1.000030960990442
07-07-2021,775249,12516,255300,519949,1.61,32.93,1.0000722400744073
07-08-2021,775297,12516,255300,519997,1.61,32.93,1.0000619155909907
07-09-2021,775347,12517,255300,520047,1.61,32.93,1.000064491414258
07-10-2021,775405,12519,255300,520105,1.61,32.92,1.0000748052162451
07-11-2021,775439,12519,255300,520139,1.61,32.92,1.0000438480535978
07-12-2021,775454,12521,255300,520154,1.61,32.92,1.000019343881337
07-13-2021,775495,12522,255300,520195,1.61,32.92,1.0000528722528996
07-14-2021,775527,12523,255300,520227,1.61,32.92,1.0000412639668856
07-15-2021,775566,12524,255300,520266,1.61,32.92,1.0000502883845437
07-16-2021,775609,12524,255300,520309,1.61,32.92,1.0000554433794158
07-17-2021,775657,12524,255300,520357,1.61,32.91,1.0000618868527829
07-18-2021,775694,12524,255300,520394,1.61,32.91,1.0000477014969245
07-19-2021,775705,12527,255300,520405,1.61,32.91,1.000014180849665
07-20-2021,775757,12531,255300,520457,1.62,32.91,1.0000670357932462
07-21-2021,775809,12534,255300,520509,1.62,32.91,1.0000670312997497
07-22-2021,775859,12534,255300,520559,1.62,32.91,1.000064448852746
07-23-2021,775926,12534,255300,520626,1.62,32.9,1.0000863558971411
07-24-2021,775979,12534,255300,520679,1.62,32.9,1.0000683054827393
07-25-2021,776037,12534,255300,520737,1.62,32.9,1.0000747442907605
07-26-2021,776056,12534,255300,520756,1.62,32.9,1.0000244833687053
07-27-2021,776129,12534,255300,520829,1.61,32.89,1.0000940653767254
07-28-2021,776229,12534,255300,520929,1.61,32.89,1.0001288445606336
07-29-2021,776298,12536,255300,520998,1.61,32.89,1.0000888912936776
07-30-2021,776358,12536,255300,521058,1.61,32.88,1.0000772899067112
07-31-2021,776444,12540,255300,521144,1.62,32.88,1.000110773637935
08-01-2021,776512,12540,255300,521212,1.61,32.88,1.0000875787564847
08-02-2021,776534,12540,255300,521234,1.61,32.88,1.0000283318223029
08-03-2021,776608,12541,255300,521308,1.61,32.87,1.000095295247858
08-04-2021,776716,12541,255300,521416,1.61,32.87,1.0001390662985703
08-05-2021,776781,12541,0,776781,1.61,0,1.000083685671468
08-06-2021,776867,12541,0,776867,1.61,0,1.0001107133155935
08-07-2021,776934,12541,0,776934,1.61,0,1.0000862438486897
08-08-2021,776988,12541,0,776988,1.61,0,1.0000695039733105
08-09-2021,777021,12541,0,777021,1.61,0,1.0000424716984047
08-10-2021,777140,12543,0,777140,1.61,0,1.0001531490139906
08-11-2021,777237,12544,0,777237,1.61,0,1.0001248166353554
08-12-2021,777332,12544,0,777332,1.61,0,1.0001222278404143
08-13-2021,777417,12544,0,777417,1.61,0,1.0001093483865324
08-14-2021,777545,12544,0,777545,1.61,0,1.0001646478016302
08-15-2021,777640,12544,0,777640,1.61,0,1.000122179423699
08-16-2021,777668,12544,0,777668,1.61,0,1.0000360063782727
08-17-2021,777787,12546,0,777787,1.61,0,1.0001530215979055
08-18-2021,777924,12547,0,777924,1.61,0,1.0001761407686165
08-19-2021,778055,12547,0,778055,1.61,0,1.000168396912809
08-20-2021,778177,12547,0,778177,1.61,0,1.00015680125441
08-21-2021,778322,12547,0,778322,1.61,0,1.0001863329293978
08-22-2021,778450,12547,0,778450,1.61,0,1.0001644563561096
08-23-2021,778501,12547,0,778501,1.61,0,1.0000655148050615
08-24-2021,778664,12547,0,778664,1.61,0,1.000209376738116
08-25-2021,778774,12547,0,778774,1.61,0,1.0001412676070809
08-26-2021,778983,12547,0,778983,1.61,0,1.0002683705413895
08-27-2021,779136,12548,0,779136,1.61,0,1.0001964099344915
08-28-2021,779324,12548,0,779324,1.61,0,1.0002412929193363
08-29-2021,779460,12548,0,779460,1.61,0,1.0001745102165467
08-30-2021,779540,12548,0,779540,1.61,0,1.0001026351576732
08-31-2021,779767,12548,0,779767,1.61,0,1.0002911973728097
09-01-2021,780075,12548,0,780075,1.61,0,1.0003949897854103
09-02-2021,780305,12548,0,780305,1.61,0,1.0002948434445407
09-03-2021,780689,12549,0,780689,1.61,0,1.0004921152626216
09-04-2021,781164,12549,0,781164,1.61,0,1.0006084369063737
09-05-2021,781455,12549,0,781455,1.61,0,1.0003725210071124
09-06-2021,781644,12551,0,781644,1.61,0,1.0002418565368447
09-07-2021,782148,12552,0,782148,1.6,0,1.0006447948170778
09-08-2021,782740,12553,0,782740,1.6,0,1.000756890000358
09-09-2021,783397,12556,0,783397,1.6,0,1.000839359174183
09-10-2021,783959,12558,0,783959,1.6,0,1.0007173885016154
09-11-2021,784662,12558,0,784662,1.6,0,1.0008967305688181
09-12-2021,785184,12558,0,785184,1.6,0,1.0006652545936976
09-13-2021,785387,12560,0,785387,1.6,0,1.0002585381260953
09-14-2021,786153,12562,0,786153,1.6,0,1.0009753153540866
09-15-2021,787184,12566,0,787184,1.6,0,1.001311449552441
09-16-2021,787646,12566,0,787646,1.6,0,1.0005869021728084
09-17-2021,788941,12569,0,788941,1.59,0,1.0016441396261773
09-18-2021,790041,12569,0,790041,1.59,0,1.001394274096542
09-19-2021,790957,12569,0,790957,1.59,0,1.0011594334977552
09-20-2021,791268,12573,0,791268,1.59,0,1.0003931945731563
09-21-2021,792516,12580,0,792516,1.59,0,1.0015772153050546
09-22-2021,794018,12589,0,794018,1.59,0,1.001895229875485
09-23-2021,795286,12592,0,795286,1.58,0,1.0015969411272792
09-24-2021,796411,12594,0,796411,1.58,0,1.0014145854447332
09-25-2021,797808,12596,0,797808,1.58,0,1.00175411941824
09-26-2021,798722,12596,0,798722,1.58,0,1.0011456390509998
09-27-2021,799121,12596,0,799121,1.58,0,1.0004995480279746
09-28-2021,800730,12606,0,800730,1.57,0,1.002013462291693
09-29-2021,802589,12620,0,802589,1.57,0,1.002321631511246
09-30-2021,804372,12637,0,804372,1.57,0,1.002221560474913
10-01-2021,805983,12649,0,805983,1.57,0,1.002002804672465
10-02-2021,807709,12649,0,807709,1.57,0,1.00214148437374
10-03-2021,808960,12668,0,808960,1.57,0,1.0015488251338043
10-04-2021,809552,12676,0,809552,1.57,0,1.0007318037974684
10-05-2021,811438,12690,0,811438,1.56,0,1.0023296835780777
10-06-2021,813926,12697,0,813926,1.56,0,1.003066161555165
10-07-2021,815858,12705,0,815858,1.56,0,1.00237368016257
10-08-2021,818022,12720,0,818022,1.55,0,1.0026524223578122
10-09-2021,820303,12729,0,820303,1.55,0,1.0027884335629116
10-10-2021,821714,12731,0,821714,1.55,0,1.0017200961108272
10-11-2021,822475,12735,0,822475,1.55,0,1.0009261129784817
10-12-2021,824687,12752,0,824687,1.55,0,1.002689443448129
10-13-2021,827648,12772,0,827648,1.54,0,1.0035904531052386
10-14-2021,830031,12791,0,830031,1.54,0,1.00287924334983
10-15-2021,832457,12816,0,832457,1.54,0,1.002922782402103
10-16-2021,834975,12816,0,834975,1.53,0,1.0030247808595518
10-17-2021,837146,12846,0,837146,1.53,0,1.0026000778466422
10-18-2021,838331,12854,0,838331,1.53,0,1.001415523695986
10-19-2021,841322,12864,0,841322,1.53,0,1.003567803170824
10-20-2021,845619,12872,0,845619,1.52,0,1.0051074380558216
10-21-2021,849611,12883,0,849611,1.52,0,1.004720802157946
10-22-2021,854024,12886,0,854024,1.51,0,1.0051941417895955
10-23-2021,858435,12895,0,858435,1.5,0,1.0051649602353097
10-24-2021,862348,12903,0,862348,1.5,0,1.0045582950368985
10-25-2021,864213,12917,0,864213,1.49,0,1.0021626999772713
10-26-2021,868738,12935,0,868738,1.49,0,1.0052359777045705
10-27-2021,874816,12957,0,874816,1.48,0,1.0069963556331138
10-28-2021,881087,12977,0,881087,1.47,0,1.0071683645475162
10-29-2021,887197,13000,0,887197,1.47,0,1.0069346159913835
10-30-2021,893866,13018,0,893866,1.46,0,1.0075169325414761
10-31-2021,898926,13034,0,898926,1.45,0,1.0056608037446328
11-01-2021,902044,13045,0,902044,1.45,0,1.0034685836208987
11-02-2021,905284,13076,0,905284,1.44,0,1.0035918425265287
11-03-2021,913536,13112,0,913536,1.44,0,1.0091153715298182
11-04-2021,922403,13146,0,922403,1.43,0,1.009706240367101
11-05-2021,931129,13166,0,931129,1.41,0,1.0094600733085213
11-06-2021,939755,13205,0,939755,1.41,0,1.009264022493124
11-07-2021,946520,13229,0,946520,1.4,0,1.007198684763582
11-08-2021,951417,13269,0,951417,1.39,0,1.005173688881376
11-09-2021,959699,13314,0,959699,1.39,0,1.00870491067534
11-10-2021,969099,13367,0,969099,1.38,0,1.0097947377250576
11-11-2021,978203,13405,0,978203,1.37,0,1.0093942930495232
11-12-2021,987623,13446,0,987623,1.36,0,1.009629902995595
11-13-2021,997514,13485,0,997514,1.35,0,1.0100149550992636
11-14-2021,1005182,13537,0,1005182,1.35,0,1.0076871101558473
11-15-2021,1010857,13598,0,1010857,1.35,0,1.0056457437558572
11-16-2021,1021273,13644,0,1021273,1.34,0,1.01030412808142
11-17-2021,1032240,13687,0,1032240,1.33,0,1.0107385586420086
11-18-2021,1040996,13725,0,1040996,1.32,0,1.0084825234441603
11-19-2021,1051745,13781,0,1051745,1.31,0,1.0103256880910205
11-20-2021,1064680,13818,0,1064680,1.3,0,1.0122986085030117
11-21-2021,1074264,13861,0,1074264,1.29,0,1.0090017657887815
11-22-2021,1081626,13919,0,1081626,1.29,0,1.0068530640512947
11-23-2021,1092704,13985,0,1092704,1.28,0,1.0102419875261874
11-24-2021,1105970,14056,0,1105970,1.27,0,1.0121405247898791
11-25-2021,1119111,14107,0,1119111,1.26,0,1.0118818774469471
11-26-2021,1131206,14177,0,1131206,1.25,0,1.010807685743416
11-27-2021,1143068,14228,0,1143068,1.24,0,1.010486153715592
11-28-2021,1152125,14274,0,1152125,1.24,0,1.0079234131302774
11-29-2021,1159767,14341,0,1159767,1.24,0,1.006632960833243
11-30-2021,1170200,14418,0,1170200,1.23,0,1.008995772426703
12-01-2021,1182562,14503,0,1182562,1.23,0,1.0105640061527943
12-02-2021,1192439,14606,0,1192439,1.22,0,1.0083522047892626
12-03-2021,1209977,14696,0,1209977,1.21,0,1.0147076705810527
12-04-2021,1221771,14771,0,1221771,1.21,0,1.0097472927171343
12-05-2021,1230343,14826,0,1230343,1.21,0,1.0070160447416088
12-06-2021,1234982,14900,0,1234982,1.21,0,1.0037704932689502
12-07-2021,1244362,15004,0,1244362,1.21,0,1.00759525240044
12-08-2021,1255086,15095,0,1255086,1.2,0,1.0086180709472004
12-09-2021,1265056,15179,0,1265056,1.2,0,1.007943678759862
12-10-2021,1272991,15236,0,1272991,1.2,0,1.0062724495990691
12-11-2021,1280370,15304,0,1280370,1.2,0,1.0057965845791526
12-12-2021,1286336,15354,0,1286336,1.19,0,1.0046595905870959
12-13-2021,1289252,15415,0,1289252,1.2,0,1.002266903826061
12-14-2021,1295909,15516,0,1295909,1.2,0,1.0051634591220335
12-15-2021,1302459,15621,0,1302459,1.2,0,1.005054367243379
12-16-2021,1310588,15730,0,1310588,1.2,0,1.0062412713183293
12-17-2021,1316172,15843,0,1316172,1.2,0,1.004260682991146
12-18-2021,1321091,15931,0,1321091,1.21,0,1.0037373534765972
12-19-2021,1325153,16014,0,1325153,1.21,0,1.0030747314151713
12-20-2021,1327031,16068,0,1327031,1.21,0,1.0014171948446708
12-21-2021,1332198,16129,0,1332198,1.21,0,1.0038936543306072
12-22-2021,1334906,16198,0,1334906,1.21,0,1.002032730870336
12-23-2021,1342324,16239,0,1342324,1.21,0,1.0055569455826852
12-24-2021,1347874,16290,0,1347874,1.21,0,1.0041346202556163
12-25-2021,1349146,16336,0,1349146,1.21,0,1.0009437083881727
12-26-2021,1349806,16398,0,1349806,1.21,0,1.0004891983521427
12-27-2021,1351450,16445,0,1351450,1.22,0,1.0012179528021063
12-28-2021,1357165,16486,0,1357165,1.21,0,1.0042287912982353
12-29-2021,1363478,16554,0,1363478,1.21,0,1.0046516083158643
12-30-2021,1367361,16598,0,1367361,1.21,0,1.00284786406528
12-31-2021,1371082,16635,0,1371082,1.21,0,1.0027213003734932
01-01-2022,1374354,16665,0,1374354,1.21,0,1.0023864364057
01-02-2022,1374850,16701,0,1374850,1.21,0,1.000360896828619
01-03-2022,1376559,16740,0,1376559,1.22,0,1.001243044695785
01-04-2022,1381175,16788,0,1381175,1.22,0,1.0033532888891794
01-05-2022,1385760,16824,0,1385760,1.21,0,1.0033196372653719
01-06-2022,1389546,16871,0,1389546,1.21,0,1.0027320748181503
01-07-2022,1391061,16896,0,1391061,1.21,0,1.001090284164756
01-08-2022,1394685,16933,0,1394685,1.21,0,1.0026052056667536
01-09-2022,1397257,16962,0,1397257,1.21,0,1.0018441440181833
01-10-2022,1398557,16989,0,1398557,1.21,0,1.0009303943369043
01-11-2022,1401959,17039,0,1401959,1.22,0,1.0024325072199416
01-12-2022,1405854,17081,0,1405854,1.21,0,1.002778255284213
01-13-2022,1409365,17128,0,1409365,1.22,0,1.0024974143830014
01-14-2022,1411568,17188,0,1411568,1.22,0,1.0015631153037006
01-15-2022,1414154,17252,0,1414154,1.22,0,1.0018320052593994
01-16-2022,1417687,17300,0,1417687,1.22,0,1.0024983134792957
01-17-2022,1419379,17352,0,1419379,1.22,0,1.001193493345146
01-18-2022,1421125,17398,0,1421125,1.22,0,1.001230115423717
01-19-2022,1431770,17459,0,1431770,1.22,0,1.0074905444630136
01-20-2022,1438877,17520,0,1438877,1.22,0,1.0049637860829603
01-21-2022,1447067,17577,0,1447067,1.21,0,1.005691938921812
01-22-2022,1454621,17612,0,1454621,1.21,0,1.0052202144061055
01-23-2022,1462998,17643,0,1462998,1.21,0,1.0057588883977338
01-24-2022,1464277,17675,0,1464277,1.21,0,1.0008742322272484
01-25-2022,1478543,17698,0,1478543,1.2,0,1.009742692127241
01-26-2022,1494945,17725,0,1494945,1.19,0,1.0110933533891135
01-27-2022,1512072,17755,0,1512072,1.17,0,1.0114566087715602
01-28-2022,1529099,17779,0,1529099,1.16,0,1.0112607071620927
01-29-2022,1546907,17796,0,1546907,1.15,0,1.011646073929811
01-30-2022,1562107,17817,0,1562107,1.14,0,1.009826059355863
01-31-2022,1569299,17830,0,1569299,1.14,0,1.0046040380076398
02-01-2022,1593001,17850,0,1593001,1.12,0,1.0151035589776072
02-02-2022,1617288,17877,0,1617288,1.11,0,1.0152460670143961
02-03-2022,1639953,17896,0,1639953,1.09,0,1.0140142015522282
02-04-2022,1660336,17921,0,1660336,1.08,0,1.0124290147339587
02-05-2022,1686936,17938,0,1686936,1.06,0,1.0160208536103537
02-06-2022,1705482,17958,0,1705482,1.05,0,1.0109938966267837
02-07-2022,1718369,17973,0,1718369,1.05,0,1.007556221642914
02-08-2022,1743941,17995,0,1743941,1.03,0,1.0148815533799784
02-09-2022,1765914,18014,0,1765914,1.02,0,1.0125996234964372
02-10-2022,1794150,18040,0,1794150,1.01,0,1.0159894536200518
02-11-2022,1818532,18064,0,1818532,0.99,0,1.0135897221525514
02-12-2022,1841934,18081,0,1841934,0.98,0,1.0128686215034983
02-13-2022,1858190,18095,0,1858190,0.97,0,1.0088255062342082
02-14-2022,1870119,18105,0,1870119,0.97,0,1.0064196879759335
02-15-2022,1891646,18123,0,1891646,0.96,0,1.0115110321856524
02-16-2022,1920150,18145,0,1920150,0.94,0,1.0150683584560747
02-17-2022,1943101,18179,0,1943101,0.94,0,1.011952712027706
02-18-2022,1964411,18201,0,1964411,0.93,0,1.0109670058324296
02-19-2022,1985859,18225,0,1985859,0.92,0,1.0109182854300856
02-20-2022,2000643,18240,0,2000643,0.91,0,1.0074446373080868
02-21-2022,2010065,18252,0,2010065,0.91,0,1.004709485900283
02-22-2022,2025646,18279,0,2025646,0.9,0,1.0077514906234375
02-23-2022,2052260,18314,0,2052260,0.89,0,1.0131385246978002
02-24-2022,2071372,18338,0,2071372,0.89,0,1.0093126601892548
02-25-2022,2083963,18375,0,2083963,0.88,0,1.006078579801214
02-26-2022,2102420,18413,0,2102420,0.88,0,1.008856683156083
02-27-2022,2112272,18453,0,2112272,0.87,0,1.0046860284814643
02-28-2022,2119358,18485,0,2119358,0.87,0,1.003354681594037
03-01-2022,2134795,18530,0,2134795,0.87,0,1.0072838095309995
03-02-2022,2150666,18567,0,2150666,0.86,0,1.0074344374986826
03-03-2022,2164751,18611,0,2164751,0.86,0,1.0065491340821866
03-04-2022,2178234,18631,0,2178234,0.86,0,1.0062284299672342
03-05-2022,2190599,18663,0,2190599,0.85,0,1.005676616929127
03-06-2022,2197979,18687,0,2197979,0.85,0,1.003368941554342
03-07-2022,2203141,18704,0,2203141,0.85,0,1.0023485210732224
03-08-2022,2216994,18750,0,2216994,0.85,0,1.0062878408599358
03-09-2022,2231352,18786,0,2231352,0.84,0,1.0064763368777723
03-10-2022,2246029,18817,0,2246029,0.84,0,1.0065776264793722
03-11-2022,2258399,18847,0,2258399,0.83,0,1.0055074978996263
03-12-2022,2269610,18881,0,2269610,0.83,0,1.004964136098183
03-13-2022,2278164,18918,0,2278164,0.83,0,1.0037689294636523
03-14-2022,2282747,18950,0,2282747,0.83,0,1.002011707673372
03-15-2022,2295377,18979,0,2295377,0.83,0,1.0055328076216943
03-16-2022,2309029,19009,0,2309029,0.82,0,1.005947606863709
03-17-2022,2322231,19040,0,2322231,0.82,0,1.0057175548683017
03-18-2022,2333162,19073,0,2333162,0.82,0,1.0047071113941723
03-19-2022,2344057,19093,0,2344057,0.81,0,1.0046696285984429
03-20-2022,2351701,19110,0,2351701,0.81,0,1.0032610128507966
03-21-2022,2355564,19133,0,2355564,0.81,0,1.001642640794897
03-22-2022,2366902,19161,0,2366902,0.81,0,1.0048132846316211
03-23-2022,2379094,19185,0,2379094,0.81,0,1.005151037094058
03-24-2022,2390390,19209,0,2390390,0.8,0,1.0047480259291983
03-25-2022,2399832,19229,0,2399832,0.8,0,1.003949983057158
03-26-2022,2408571,19251,0,2408571,0.8,0,1.0036415049053433
03-27-2022,2414805,19270,0,2414805,0.8,0,1.002588256688302
03-28-2022,2418385,19292,0,2418385,0.8,0,1.0014825213630085
03-29-2022,2426662,19311,0,2426662,0.8,0,1.003422531978986
03-30-2022,2434708,19334,0,2434708,0.79,0,1.0033156657169395
03-31-2022,2443137,19352,0,2443137,0.79,0,1.003462016800372
04-01-2022,2450101,19368,0,2450101,0.79,0,1.0028504336842345
04-02-2022,2456636,19392,0,2456636,0.79,0,1.0026672369832916
04-03-2022,2460197,19417,0,2460197,0.79,0,1.0014495431964687
04-04-2022,2462300,19440,0,2462300,0.79,0,1.0008548095945162
04-05-2022,2468812,19462,0,2468812,0.79,0,1.0026446818015677
04-06-2022,2474869,19482,0,2474869,0.79,0,1.00245340673976
04-07-2022,2480132,19500,0,2480132,0.79,0,1.0021265772046926
04-08-2022,2484354,19523,0,2484354,0.79,0,1.0017023287470184
04-09-2022,2488243,19549,0,2488243,0.79,0,1.0015653968798328
04-10-2022,2490661,19573,0,2490661,0.79,0,1.0009717700401448
04-11-2022,2491957,19595,0,2491957,0.79,0,1.0005203437962853
04-12-2022,2495855,19618,0,2495855,0.79,0,1.0015642324486338
04-13-2022,2498938,19643,0,2498938,0.79,0,1.0012352480412523
04-14-2022,2498938,19643,0,2498938,0.79,0,1.0
04-15-2022,2504931,19697,0,2504931,0.79,0,1.0023982187633307
04-16-2022,2505968,19721,0,2505968,0.79,0,1.0004139834590253
04-17-2022,2506879,19741,0,2506879,0.79,0,1.0003635321759894
04-18-2022,2506879,19741,0,2506879,0.79,0,1.0
04-19-2022,2509184,19773,0,2509184,0.79,0,1.0009194699863855
04-20-2022,2508400,19790,0,2508400,0.79,0,1.0003124521756874
04-21-2022,2514884,19803,0,2514884,0.79,0,1.0025849146866528
04-22-2022,2517571,19817,0,2517571,0.79,0,1.0010684389419153
04-23-2022,2519448,19829,0,2519448,0.79,0,1.0007455599067514
04-24-2022,2520706,19839,0,2520706,0.79,0,1.0004993157231266
04-25-2022,2521279,19852,0,2521279,0.79,0,1.000227317267464
04-26-2022,2523096,19862,0,2523096,0.79,0,1.0007206659794494
04-27-2022,2526855,19873,0,2526855,0.79,0,1.0014898362963598
04-28-2022,2528216,19879,0,2528216,0.79,0,1.000538614206197
04-29-2022,2528216,19879,0,2528216,0.79,0,1.0
04-30-2022,2528216,19879,0,2528216,0.79,0,1.0
05-01-2022,2528216,19879,0,2528216,0.79,0,1.0
05-02-2022,2528216,19879,0,2528216,0.79,0,1.0
05-03-2022,2528216,19879,0,2528216,0.79,0,1.0
05-04-2022,2533654,19943,0,2533654,0.79,0,1.0021509238134716
05-05-2022,2534433,19952,0,2534433,0.79,0,1.0003074610818998
05-06-2022,2535084,19961,0,2535084,0.79,0,1.0002568621857433
05-07-2022,2535706,19968,0,2535706,0.79,0,1.0002453567613538
05-08-2022,2536000,19978,0,2536000,0.79,0,1.0001159440408312
05-09-2022,2536111,19984,0,2536111,0.79,0,1.0000437697160884
05-10-2022,2536743,19994,0,2536743,0.79,0,1.000249200449034
05-11-2022,2537377,20002,0,2537377,0.79,0,1.000249926776185
05-12-2022,2537896,20011,0,2537896,0.79,0,1.0002045419344465
05-13-2022,2538274,20018,0,2538274,0.79,0,1.0001489422734422
05-14-2022,2538274,20018,0,2538274,0.79,0,1.0
05-15-2022,2538964,20041,0,2538964,0.79,0,1.0002718382648996
05-16-2022,2539041,20050,0,2539041,0.79,0,1.00003032733036
05-17-2022,2539498,20062,0,2539498,0.79,0,1.000179989216401
05-18-2022,2539862,20069,0,2539862,0.79,0,1.0001433354151097
05-19-2022,2539862,20069,0,2539862,0.79,0,1.0
05-20-2022,2540471,20075,0,2540471,0.79,0,1.0002397768067715
05-21-2022,2540471,20075,0,2540471,0.79,0,1.0
05-22-2022,2541509,20088,0,2541509,0.79,0,1.0004085856520306
05-23-2022,2540935,20081,0,2540935,0.79,0,1.0002258500756833
05-24-2022,2541256,20083,0,2541256,0.79,0,1.0001263314488564
05-25-2022,2541509,20088,0,2541509,0.79,0,1.0000995570694176
05-26-2022,2541509,20088,0,2541509,0.79,0,1.0
05-27-2022,2541986,20093,0,2541986,0.79,0,1.0001876837736952
05-28-2022,2542191,20096,0,2542191,0.79,0,1.0000806456054439
05-29-2022,2542299,20097,0,2542299,0.79,0,1.0000424830392367
05-30-2022,2542345,20098,0,2542345,0.79,0,1.000018093859141
05-31-2022,2542564,20100,0,2542564,0.79,0,1.000086140944679
06-01-2022,2542773,20100,0,2542773,0.79,0,1.000082200487382
06-02-2022,2542970,20101,0,2542970,0.79,0,1.000077474473734
06-03-2022,2543160,20103,0,2543160,0.79,0,1.000074715785086
06-04-2022,2543341,20104,0,2543341,0.79,0,1.0000711712986992
06-05-2022,2543439,20104,0,2543439,0.79,0,1.0000385319939402
06-06-2022,2543503,20104,0,2543503,0.79,0,1.0000251627815726
06-07-2022,2543763,20105,0,2543763,0.79,0,1.000102221227968
06-08-2022,2543993,20107,0,2543993,0.79,0,1.0000904172283345
06-09-2022,2544255,20109,0,2544255,0.79,0,1.0001029877047618
06-10-2022,2544473,20112,0,2544473,0.79,0,1.0000856832353675
06-11-2022,2544678,20114,0,2544678,0.79,0,1.000080566781412
06-12-2022,2544678,20114,0,2544678,0.79,0,1.0
06-13-2022,2544823,20116,0,2544823,0.79,0,1.0000569816691935
06-14-2022,2545137,20119,0,2545137,0.79,0,1.0001233877562408
06-15-2022,2545409,20119,0,2545409,0.79,0,1.000106870474949
06-16-2022,2545651,20122,0,2545651,0.79,0,1.0000950731297014
06-17-2022,2545879,20126,0,2545879,0.79,0,1.00008956451611
06-18-2022,2546134,20130,0,2546134,0.79,0,1.0001001618694367
06-19-2022,2546134,20130,0,2546134,0.79,0,1.0
06-20-2022,2546346,20137,0,2546346,0.79,0,1.0000832634888817
06-21-2022,2546800,20137,0,2546800,0.79,0,1.0001782947015057
06-22-2022,2547229,20140,0,2547229,0.79,0,1.0001684466781844
06-23-2022,2547645,20142,0,2547645,0.79,0,1.0001633147235682
06-24-2022,2548069,20142,0,2548069,0.79,0,1.0001664282111518
06-25-2022,2548586,20142,0,2548586,0.79,0,1.0002028987441078
06-26-2022,2548819,20142,0,2548819,0.79,0,1.0000914232441047
06-27-2022,2548964,20142,0,2548964,0.79,0,1.0000568890925563
06-28-2022,2549692,20144,0,2549692,0.79,0,1.0002856062306098
06-29-2022,2550368,20146,0,2550368,0.79,0,1.0002651300627683
06-30-2022,2551116,20147,0,2551116,0.79,0,1.0002932910074154
07-01-2022,2551116,20147,0,2551116,0.79,0,1.0
07-02-2022,2551116,20147,0,2551116,0.79,0,1.0
07-03-2022,2551116,20147,0,2551116,0.79,0,1.0
07-04-2022,2551116,20147,0,2551116,0.79,0,1.0
07-05-2022,2551116,20147,0,2551116,0.79,0,1.0
07-06-2022,2554112,20152,0,2554112,0.79,0,1.001174387993333
07-07-2022,2555080,20154,0,2555080,0.79,0,1.0003789966923926
07-08-2022,2556052,20157,0,2556052,0.79,0,1.0003804186170295
07-09-2022,2557202,20159,0,2557202,0.79,0,1.0004499125995872
07-10-2022,2557640,20160,0,2557640,0.79,0,1.000171280954731
07-11-2022,2557839,20160,0,2557839,0.79,0,1.0000778061025006
07-12-2022,2559088,20163,0,2559088,0.79,0,1.0004883028212488
07-13-2022,2560261,20166,0,2560261,0.79,0,1.0004583664180364
07-14-2022,2561338,20168,0,2561338,0.79,0,1.0004206602373742
07-15-2022,2562431,20169,0,2562431,0.79,0,1.0004267300918503
07-16-2022,2563799,20171,0,2563799,0.79,0,1.00053386803391
07-17-2022,2564393,20172,0,2564393,0.79,0,1.0002316874294748
07-18-2022,2564633,20172,0,2564633,0.79,0,1.0000935893991287
07-19-2022,2566215,20176,0,2566215,0.79,0,1.0006168523917458
07-20-2022,2567776,20183,0,2567776,0.79,0,1.0006082888612218
07-21-2022,2569210,20188,0,2569210,0.79,0,1.0005584599279689
07-22-2022,2570582,20193,0,2570582,0.79,0,1.0005340162929461
07-23-2022,2571985,20195,0,2571985,0.79,0,1.0005457907975703
07-24-2022,2572792,20197,0,2572792,0.79,0,1.0003137654379788
07-25-2022,2573084,20198,0,2573084,0.78,0,1.0001134953777842
07-26-2022,2574932,20201,0,2574932,0.78,0,1.0007182043026968
07-27-2022,2576509,20206,0,2576509,0.78,0,1.0006124433577275
07-28-2022,2577417,20212,0,2577417,0.78,0,1.0003524148372855
07-29-2022,2578855,20216,0,2578855,0.78,0,1.0005579229127457
07-30-2022,2580451,20219,0,2580451,0.78,0,1.0006188793088406
07-31-2022,2581047,20223,0,2581047,0.78,0,1.0002309673774081
08-01-2022,2581323,20227,0,2581323,0.78,0,1.0001069333491408
08-02-2022,2582793,20232,0,2582793,0.78,0,1.0005694754201624
08-03-2022,2584276,20236,0,2584276,0.78,0,1.0005741846133236
08-04-2022,2580748,20236,0,2580748,0.78,0,1.0013651792610387
08-05-2022,2580748,20236,0,2580748,0.78,0,1.0
08-06-2022,2580748,20236,0,2580748,0.78,0,1.0
08-07-2022,2580748,20236,0,2580748,0.78,0,1.0
08-08-2022,2580748,20236,0,2580748,0.78,0,1.0
08-09-2022,2580748,20236,0,2580748,0.78,0,1.0
08-10-2022,2580748,20236,0,2580748,0.78,0,1.0
08-11-2022,2580748,20236,0,2580748,0.78,0,1.0
08-12-2022,2580748,20236,0,2580748,0.78,0,1.0
08-13-2022,2580748,20236,0,2580748,0.78,0,1.0
08-14-2022,2580748,20236,0,2580748,0.78,0,1.0
08-15-2022,2580748,20236,0,2580748,0.78,0,1.0
08-16-2022,2580748,20236,0,2580748,0.78,0,1.0
08-17-2022,2580748,20236,0,2580748,0.78,0,1.0
08-18-2022,2580748,20236,0,2580748,0.78,0,1.0
08-19-2022,2580748,20236,0,2580748,0.78,0,1.0
08-20-2022,2580748,20236,0,2580748,0.78,0,1.0
08-21-2022,2580748,20236,0,2580748,0.78,0,1.0
08-22-2022,2580748,20236,0,2580748,0.78,0,1.0
08-23-2022,2580748,20236,0,2580748,0.78,0,1.0
08-24-2022,2580748,20236,0,2580748,0.78,0,1.0
08-25-2022,2580748,20236,0,2580748,0.78,0,1.0
08-26-2022,2580748,20236,0,2580748,0.78,0,1.0
08-27-2022,2580748,20236,0,2580748,0.78,0,1.0
08-28-2022,2580748,20236,0,2580748,0.78,0,1.0
08-29-2022,2580748,20236,0,2580748,0.78,0,1.0
08-30-2022,2580748,20236,0,2580748,0.78,0,1.0
08-31-2022,2580748,20236,0,2580748,0.78,0,1.0
09-01-2022,2580748,20236,0,2580748,0.78,0,1.0
09-02-2022,2580748,20236,0,2580748,0.78,0,1.0
09-03-2022,2580748,20236,0,2580748,0.78,0,1.0
09-04-2022,2580748,20236,0,2580748,0.78,0,1.0
09-05-2022,2580748,20236,0,2580748,0.78,0,1.0
09-06-2022,2580748,20236,0,2580748,0.78,0,1.0
09-07-2022,2580748,20236,0,2580748,0.78,0,1.0
09-08-2022,2580748,20236,0,2580748,0.78,0,1.0
09-09-2022,2580748,20236,0,2580748,0.78,0,1.0
09-10-2022,2580748,20236,0,2580748,0.78,0,1.0
09-11-2022,2580748,20236,0,2580748,0.78,0,1.0
09-12-2022,2580748,20236,0,2580748,0.78,0,1.0
09-13-2022,2580748,20236,0,2580748,0.78,0,1.0
09-14-2022,2614381,20421,0,2614381,0.78,0,1.0130322681641137
09-15-2022,2614850,20426,0,2614850,0.78,0,1.000179392368595
09-16-2022,2614999,20429,0,2614999,0.78,0,1.0000569822360748
09-17-2022,2615778,20433,0,2615778,0.78,0,1.0002978968634404
09-18-2022,2616071,20436,0,2616071,0.78,0,1.0001120125637573
09-19-2022,2616213,20436,0,2616213,0.78,0,1.0000542798723735
09-20-2022,2617274,20439,0,2617274,0.78,0,1.000405548019217
09-21-2022,2618312,20439,0,2618312,0.78,0,1.0003965958474352
09-22-2022,2619156,20441,0,2619156,0.78,0,1.0003223450833973
09-23-2022,2619905,20443,0,2619905,0.78,0,1.000285969984224
09-24-2022,2620636,20446,0,2620636,0.78,0,1.0002790177506435
09-25-2022,2620982,20448,0,2620982,0.78,0,1.00013202901891
09-26-2022,2621147,20450,0,2621147,0.78,0,1.0000629535036867
09-27-2022,2622211,20453,0,2622211,0.78,0,1.0004059291600205
09-28-2022,2623345,20454,0,2623345,0.78,0,1.0004324594778986
09-29-2022,2624386,20455,0,2624386,0.78,0,1.0003968216151518
09-30-2022,2625317,20457,0,2625317,0.78,0,1.0003547496442977
10-01-2022,2626218,20459,0,2626218,0.78,0,1.0003431966501568
10-02-2022,2626595,20461,0,2626595,0.78,0,1.0001435524392872
10-03-2022,2626750,20462,0,2626750,0.78,0,1.0000590117623767
10-04-2022,2627964,20465,0,2627964,0.78,0,1.0004621680784238
10-05-2022,2629146,20467,0,2629146,0.78,0,1.000449777850838
10-06-2022,2630134,20470,0,2630134,0.78,0,1.0003757874229884
10-07-2022,2631043,20472,0,2631043,0.78,0,1.000345609767411
10-08-2022,2631965,20475,0,2631965,0.78,0,1.0003504313688525
10-09-2022,2632299,20478,0,2632299,0.78,0,1.000126901383567
10-10-2022,2632434,20481,0,2632434,0.78,0,1.0000512859671338
10-11-2022,2633464,20485,0,2633464,0.78,0,1.0003912728676199
10-12-2022,2634435,20491,0,2634435,0.78,0,1.0003687158814398
10-13-2022,2635303,20496,0,2635303,0.78,0,1.0003294824127376
10-14-2022,2635955,20501,0,2635955,0.78,0,1.000247409880382
10-15-2022,2636652,20507,0,2636652,0.78,0,1.0002644202954907
10-16-2022,2636880,20511,0,2636880,0.78,0,1.0000864733002308
10-17-2022,2637041,20518,0,2637041,0.78,0,1.0000610570067656
10-18-2022,2637967,20523,0,2637967,0.78,0,1.0003511511576801
10-19-2022,2638637,20530,0,2638637,0.78,0,1.0002539834652973
10-20-2022,2639268,20538,0,2639268,0.78,0,1.000239138615884
10-21-2022,2639764,20543,0,2639764,0.78,0,1.000187930895991
10-22-2022,2640305,20551,0,2640305,0.78,0,1.0002049425630473
10-23-2022,2640491,20557,0,2640491,0.78,0,1.0000704464067598
10-24-2022,2640612,20564,0,2640612,0.78,0,1.0000458248106128
10-25-2022,2641225,20573,0,2641225,0.78,0,1.000232143154693
10-26-2022,2641696,20579,0,2641696,0.78,0,1.0001783263447832
10-27-2022,2642129,20586,0,2642129,0.78,0,1.0001639098518527
10-28-2022,2642518,20592,0,2642518,0.78,0,1.0001472297529757
10-29-2022,2642968,20597,0,2642968,0.78,0,1.0001702921228919
10-30-2022,2643113,20601,0,2643113,0.78,0,1.0000548625636028
10-31-2022,2643182,20606,0,2643182,0.78,0,1.0000261055808057
11-01-2022,2643658,20609,0,2643658,0.78,0,1.000180085972135
11-02-2022,2643774,20614,0,2643774,0.78,0,1.0000438785954915
11-03-2022,2644213,20620,0,2644213,0.78,0,1.0001660505020475
11-04-2022,2644627,20624,0,2644627,0.78,0,1.0001565683248663
11-05-2022,2644984,20629,0,2644984,0.78,0,1.0001349906811055
11-06-2022,2645118,20635,0,2645118,0.78,0,1.0000506619321705
11-07-2022,2645192,20641,0,2645192,0.78,0,1.0000279760676083
11-08-2022,2645588,20645,0,2645588,0.78,0,1.0001497055790278
11-09-2022,2645927,20651,0,2645927,0.78,0,1.0001281378657598
11-10-2022,2646203,20656,0,2646203,0.78,0,1.0001043112678467
11-11-2022,2646511,20663,0,2646511,0.78,0,1.000116393186766
11-12-2022,2646740,20670,0,2646740,0.78,0,1.0000865290187722
11-13-2022,2646860,20676,0,2646860,0.78,0,1.0000453387941393
11-14-2022,2646893,20684,0,2646893,0.78,0,1.0000124676031221
11-15-2022,2647233,20689,0,2647233,0.78,0,1.0001284524912795
11-16-2022,2647488,20696,0,2647488,0.78,0,1.0000963269950172
11-17-2022,2647741,20700,0,2647741,0.78,0,1.0000955622839462
11-18-2022,2647809,20705,0,2647809,0.78,0,1.0000256822702824
11-19-2022,2647985,20709,0,2647985,0.78,0,1.0000664700512762
11-20-2022,2648095,20711,0,2648095,0.78,0,1.0000415410208139
11-21-2022,2648151,20712,0,2648151,0.78,0,1.0000211472775713
11-22-2022,2648456,20715,0,2648456,0.78,0,1.0001151747011405
11-23-2022,2648680,20719,0,2648680,0.78,0,1.0000845775802958
11-24-2022,2648927,20722,0,2648927,0.78,0,1.000093253998218
11-25-2022,2649166,20725,0,2649166,0.78,0,1.0000902252119444
11-26-2022,2649432,20727,0,2649432,0.78,0,1.000100408958895
11-27-2022,2649520,20729,0,2649520,0.78,0,1.0000332146663888
11-28-2022,2649580,20729,0,2649580,0.78,0,1.0000226456112806
11-29-2022,2649967,20732,0,2649967,0.78,0,1.0001460608851214
11-30-2022,2650230,20733,0,2650230,0.78,0,1.000099246518919
12-01-2022,2650472,20734,0,2650472,0.78,0,1.0000913128294526
12-02-2022,2650690,20737,0,2650690,0.78,0,1.000082249501221
12-03-2022,2650937,20740,0,2650937,0.78,0,1.0000931832843525
12-04-2022,2651038,20741,0,2651038,0.78,0,1.0000380997360556
12-05-2022,2651069,20742,0,2651069,0.78,0,1.000011693532873
12-06-2022,2651459,20745,0,2651459,0.78,0,1.0001471104675133
12-07-2022,2651788,20747,0,2651788,0.78,0,1.0001240826277156
12-08-2022,2652086,20750,0,2652086,0.78,0,1.0001123770075133
12-09-2022,2652388,20752,0,2652388,0.78,0,1.0001138726270566
12-10-2022,2652676,20756,0,2652676,0.78,0,1.0001085813991015
12-11-2022,2652759,20761,0,2652759,0.78,0,1.0000312891585705
12-12-2022,2652801,20764,0,2652801,0.78,0,1.0000158325728044
12-13-2022,2653246,20770,0,2653246,0.78,0,1.0001677472226527
12-14-2022,2653639,20773,0,2653639,0.78,0,1.000148120453211
12-15-2022,2653925,20776,0,2653925,0.78,0,1.0001077765287592
12-16-2022,2654148,20778,0,2654148,0.78,0,1.000084026489068
12-17-2022,2654422,20781,0,2654422,0.78,0,1.000103234634994
12-18-2022,2654526,20783,0,2654526,0.78,0,1.0000391799043258
12-19-2022,2654567,20785,0,2654567,0.78,0,1.0000154453186747
12-20-2022,2654985,20788,0,2654985,0.78,0,1.000157464475374
12-21-2022,2655276,20792,0,2655276,0.78,0,1.0001096051390121
12-22-2022,2655504,20794,0,2655504,0.78,0,1.0000858667799506
12-23-2022,2655814,20797,0,2655814,0.78,0,1.0001167386680645
12-24-2022,2656055,20799,0,2656055,0.78,0,1.000090744306642
12-25-2022,2656101,20803,0,2656101,0.78,0,1.0000173189184711
12-26-2022,2656155,20806,0,2656155,0.78,0,1.000020330552189
12-27-2022,2656241,20808,0,2656241,0.78,0,1.0000323776285647
12-28-2022,2656552,20813,0,2656552,0.78,0,1.000117082749645
12-29-2022,2656851,20817,0,2656851,0.78,0,1.0001125519093923
12-30-2022,2657070,20821,0,2657070,0.78,0,1.0000824284086687
12-31-2022,2657292,20823,0,2657292,0.78,0,1.0000835506780024
01-01-2023,2657365,20823,0,2657365,0.78,0,1.0000274715763267
01-02-2023,2657398,20825,0,2657398,0.78,0,1.0000124183166408
01-03-2023,2657650,20827,0,2657650,0.78,0,1.000094829603996
01-04-2023,2657865,20830,0,2657865,0.78,0,1.0000808985381822
01-05-2023,2658031,20833,0,2658031,0.78,0,1.0000624561443112
01-06-2023,2658192,20838,0,2658192,0.78,0,1.0000605711521047
01-07-2023,2658243,20841,0,2658243,0.78,0,1.0000191859730223
01-08-2023,2658271,20845,0,2658271,0.78,0,1.0000105332732936
01-09-2023,2658286,20849,0,2658286,0.78,0,1.000005642765542
01-10-2023,2658560,20855,0,2658560,0.78,0,1.0001030739356112
01-11-2023,2658745,20859,0,2658745,0.78,0,1.000069586543091
01-12-2023,2658893,20862,0,2658893,0.78,0,1.0000556653609127
01-13-2023,2659077,20866,0,2659077,0.78,0,1.000069201731698
01-14-2023,2659130,20870,0,2659130,0.78,0,1.00001993172819
01-15-2023,2659236,20875,0,2659236,0.78,0,1.000039862661848
01-16-2023,2659251,20878,0,2659251,0.79,0,1.0000056407178604
01-17-2023,2659408,20882,0,2659408,0.79,0,1.0000590391805813
01-18-2023,2659532,20888,0,2659532,0.79,0,1.000046626918472
01-19-2023,2659652,20894,0,2659652,0.79,0,1.0000451207204877
01-20-2023,2659749,20897,0,2659749,0.79,0,1.0000364709367993
01-21-2023,2659853,20901,0,2659853,0.79,0,1.0000391014340075
01-22-2023,2659881,20906,0,2659881,0.79,0,1.000010526897539
01-23-2023,2659895,20911,0,2659895,0.79,0,1.0000052633933623
01-24-2023,2660043,20915,0,2660043,0.79,0,1.0000556412941113
01-25-2023,2660177,20918,0,2660177,0.79,0,1.000050375125515
01-26-2023,2660278,20924,0,2660278,0.79,0,1.0000379673984099
01-27-2023,2660377,20929,0,2660377,0.79,0,1.0000372141558138
01-28-2023,2660490,20935,0,2660490,0.79,0,1.0000424751830286
01-29-2023,2660507,20938,0,2660507,0.79,0,1.000006389800375
01-30-2023,2660530,20940,0,2660530,0.79,0,1.0000086449687973
01-31-2023,2660689,20942,0,2660689,0.79,0,1.0000597625285188
02-01-2023,2660846,20946,0,2660846,0.79,0,1.0000590072721764
02-02-2023,2661008,20949,0,2661008,0.79,0,1.000060882892133
02-03-2023,2661149,20952,0,2661149,0.79,0,1.0000529874393462
02-04-2023,2661284,20957,0,2661284,0.79,0,1.0000507299666421
02-05-2023,2661315,20961,0,2661315,0.79,0,1.0000116485125226
02-06-2023,2661348,20964,0,2661348,0.79,0,1.0000123998850192
02-07-2023,2661623,20966,0,2661623,0.79,0,1.0001033310938667
02-08-2023,2661781,20969,0,2661781,0.79,0,1.0000593622763254
02-09-2023,2661944,20973,0,2661944,0.79,0,1.0000612371941944
02-10-2023,2662097,20974,0,2662097,0.79,0,1.0000574767913977
02-11-2023,2662257,20977,0,2662257,0.79,0,1.000060102993993
02-12-2023,2662318,20980,0,2662318,0.79,0,1.0000229128893265
02-13-2023,2662353,20982,0,2662353,0.79,0,1.0000131464385547
02-14-2023,2662668,20986,0,2662668,0.79,0,1.0001183163915528
02-15-2023,2662918,20989,0,2662918,0.79,0,1.0000938907892385
02-16-2023,2663109,20991,0,2663109,0.79,0,1.0000717258285836
02-17-2023,2663276,20993,0,2663276,0.79,0,1.0000627086611926
02-18-2023,2663541,20995,0,2663541,0.79,0,1.0000995015161778
02-19-2023,2663604,20996,0,2663604,0.79,0,1.000023652723949
02-20-2023,2663620,20999,0,2663620,0.79,0,1.0000060068989234
02-21-2023,2663896,21003,0,2663896,0.79,0,1.0001036183840037
02-22-2023,2664186,21008,0,2664186,0.79,0,1.00010886310877
02-23-2023,2664397,21011,0,2664397,0.79,0,1.000079198674567
02-24-2023,2664595,21014,0,2664595,0.79,0,1.0000743132498648
02-25-2023,2664862,21016,0,2664862,0.79,0,1.0001002028450854
02-26-2023,2664926,21017,0,2664926,0.79,0,1.0000240162529992
02-27-2023,2664972,21017,0,2664972,0.79,0,1.0000172612672922
02-28-2023,2665303,21021,0,2665303,0.79,0,1.0001242039315985
03-01-2023,2665548,21024,0,2665548,0.79,0,1.0000919220066162
03-02-2023,2665765,21026,0,2665765,0.79,0,1.000081409151139
03-03-2023,2666004,21029,0,2666004,0.79,0,1.0000896553147032
03-04-2023,2666342,21030,0,2666342,0.79,0,1.000126781505204
03-05-2023,2666373,21030,0,2666373,0.79,0,1.000011626415516
03-06-2023,2666427,21031,0,2666427,0.79,0,1.0000202522302768
03-07-2023,2666915,21031,0,2666915,0.79,0,1.0001830164486034
03-08-2023,2667289,21033,0,2667289,0.79,0,1.0001402369404349
03-09-2023,2667551,21035,0,2667551,0.79,0,1.0000982270762562
