date,total_confirmed,total_deaths,total_recovered,total_infected,mortality_rate,recovery_rate,daily_growth_rate
02-27-2020,1,0,0,1,0.0,0.0,1
02-28-2020,1,0,0,1,0.0,0.0,1.0
02-29-2020,1,0,0,1,0.0,0.0,1.0
03-01-2020,1,0,0,1,0.0,0.0,1.0
03-02-2020,8,0,0,8,0.0,0.0,8.0
03-03-2020,10,1,0,10,10.0,0.0,1.25
03-04-2020,16,1,0,16,6.25,0.0,1.6
03-05-2020,21,1,0,21,4.76,0.0,1.3125
03-06-2020,21,1,0,21,4.76,0.0,1.0
03-07-2020,23,1,0,23,4.35,0.0,1.0952380952380953
03-08-2020,36,1,0,36,2.78,0.0,1.5652173913043477
03-09-2020,36,1,0,36,2.78,0.0,1.0
03-10-2020,51,2,0,51,3.92,0.0,1.4166666666666667
03-11-2020,62,2,0,62,3.23,0.0,1.215686274509804
03-12-2020,69,3,0,69,4.35,0.0,1.1129032258064515
03-13-2020,80,5,0,80,6.25,0.0,1.1594202898550725
03-14-2020,80,5,4,76,6.25,5.0,1.0
03-15-2020,101,5,4,97,4.95,3.96,1.2625
03-16-2020,109,7,4,105,6.42,3.67,1.0792079207920793
03-17-2020,109,7,4,105,6.42,3.67,1.0
03-18-2020,119,11,4,115,9.24,3.36,1.091743119266055
03-19-2020,119,11,4,115,9.24,3.36,1.0
03-20-2020,144,14,4,140,9.72,2.78,1.2100840336134453
03-21-2020,144,20,4,140,13.89,2.78,1.0
03-22-2020,175,20,4,171,11.43,2.29,1.2152777777777777
03-23-2020,187,20,4,183,10.7,2.14,1.0685714285714285
03-24-2020,187,21,4,183,11.23,2.14,1.0
03-25-2020,208,21,4,204,10.1,1.92,1.1122994652406417
03-26-2020,208,21,4,204,10.1,1.92,1.0
03-27-2020,223,21,4,219,9.42,1.79,1.0721153846153846
03-28-2020,224,22,6,218,9.82,2.68,1.0044843049327354
03-29-2020,224,22,6,218,9.82,2.68,1.0
03-30-2020,230,25,13,217,10.87,5.65,1.0267857142857142
03-31-2020,236,26,13,223,11.02,5.51,1.0260869565217392
04-01-2020,236,26,13,223,11.02,5.51,1.0
04-02-2020,245,30,21,224,12.24,8.57,1.0381355932203389
04-03-2020,245,30,21,224,12.24,8.57,1.0
04-04-2020,259,32,27,232,12.36,10.42,1.0571428571428572
04-05-2020,266,32,35,231,12.03,13.16,1.027027027027027
04-06-2020,266,32,35,231,12.03,13.16,1.0
04-07-2020,279,34,40,239,12.19,14.34,1.0488721804511278
04-08-2020,279,34,40,239,12.19,14.34,1.0
04-09-2020,333,34,49,284,10.21,14.71,1.1935483870967742
04-10-2020,344,34,50,294,9.88,14.53,1.033033033033033
04-11-2020,356,35,53,303,9.83,14.89,1.0348837209302326
04-12-2020,356,35,53,303,9.83,14.89,1.0
04-13-2020,356,35,53,303,9.83,14.89,1.0
04-14-2020,371,36,53,318,9.7,14.29,1.0421348314606742
04-15-2020,372,36,53,319,9.68,14.25,1.0026954177897573
04-16-2020,426,38,55,371,8.92,12.91,1.1451612903225807
04-17-2020,435,39,57,378,8.97,13.1,1.0211267605633803
04-18-2020,455,39,60,395,8.57,13.19,1.0459770114942528
04-19-2020,461,39,60,401,8.46,13.02,1.0131868131868131
04-20-2020,462,39,61,401,8.44,13.2,1.002169197396963
04-21-2020,476,40,62,414,8.4,13.03,1.0303030303030303
04-22-2020,488,40,62,426,8.2,12.7,1.0252100840336134
04-23-2020,501,40,63,438,7.98,12.57,1.026639344262295
04-24-2020,513,40,64,449,7.8,12.48,1.0239520958083832
04-25-2020,513,40,64,449,7.8,12.48,1.0
04-26-2020,538,41,64,474,7.62,11.9,1.0487329434697856
04-27-2020,538,41,64,474,7.62,11.9,1.0
04-28-2020,553,41,64,489,7.41,11.57,1.0278810408921932
04-29-2020,563,41,69,494,7.28,12.26,1.0180831826401446
04-30-2020,569,41,78,491,7.21,13.71,1.0106571936056838
05-01-2020,580,41,82,498,7.07,14.14,1.0193321616871704
05-02-2020,580,41,83,497,7.07,14.31,1.0
05-03-2020,582,41,86,496,7.04,14.78,1.0034482758620689
05-04-2020,582,41,86,496,7.04,14.78,1.0
05-05-2020,589,41,92,497,6.96,15.62,1.0120274914089347
05-06-2020,608,41,97,511,6.74,15.95,1.032258064516129
05-07-2020,622,41,106,516,6.59,17.04,1.0230263157894737
05-08-2020,623,41,114,509,6.58,18.3,1.0016077170418007
05-09-2020,637,41,126,511,6.44,19.78,1.0224719101123596
05-10-2020,628,41,126,502,6.53,20.06,1.0141287284144427
05-11-2020,628,41,130,498,6.53,20.7,1.0
05-12-2020,638,41,161,477,6.43,25.24,1.015923566878981
05-13-2020,643,41,161,482,6.38,25.04,1.0078369905956113
05-14-2020,648,41,172,476,6.33,26.54,1.0077760497667185
05-15-2020,652,41,189,463,6.29,28.99,1.0061728395061729
05-16-2020,653,41,198,455,6.28,30.32,1.0015337423312884
05-17-2020,654,41,201,453,6.27,30.73,1.001531393568147
05-18-2020,654,41,203,451,6.27,31.04,1.0
05-19-2020,655,41,211,444,6.26,32.21,1.0015290519877675
05-20-2020,656,41,220,436,6.25,33.54,1.001526717557252
05-21-2020,658,41,235,423,6.23,35.71,1.0030487804878048
05-22-2020,661,41,254,407,6.2,38.43,1.0045592705167172
05-23-2020,665,42,266,399,6.32,40.0,1.006051437216339
05-24-2020,665,42,266,399,6.32,40.0,1.0
05-25-2020,666,42,270,396,6.31,40.54,1.0015037593984963
05-26-2020,666,42,275,391,6.31,41.29,1.0
05-27-2020,667,42,294,373,6.3,44.08,1.0015015015015014
05-28-2020,670,42,322,348,6.27,48.06,1.0044977511244377
05-29-2020,671,42,344,327,6.26,51.27,1.001492537313433
05-30-2020,671,42,357,314,6.26,53.2,1.0
05-31-2020,671,42,357,314,6.26,53.2,1.0
06-01-2020,671,42,359,312,6.26,53.5,1.0
06-02-2020,672,42,384,288,6.25,57.14,1.0014903129657229
06-03-2020,674,42,391,283,6.23,58.01,1.0029761904761905
06-04-2020,678,42,408,270,6.19,60.18,1.0059347181008902
06-05-2020,680,42,428,252,6.18,62.94,1.0029498525073746
06-06-2020,680,42,428,252,6.18,62.94,1.0
06-07-2020,680,42,428,252,6.18,62.94,1.0
06-08-2020,687,42,478,209,6.11,69.58,1.0102941176470588
06-09-2020,688,42,483,205,6.1,70.2,1.0014556040756915
06-10-2020,691,42,496,195,6.08,71.78,1.004360465116279
06-11-2020,691,42,496,195,6.08,71.78,1.0
06-12-2020,694,42,520,174,6.05,74.93,1.004341534008683
06-13-2020,694,42,520,174,6.05,74.93,1.0
06-14-2020,694,42,520,174,6.05,74.93,1.0
06-15-2020,694,42,575,119,6.05,82.85,1.0
06-16-2020,694,42,590,104,6.05,85.01,1.0
06-17-2020,696,42,591,105,6.03,84.91,1.0028818443804035
06-18-2020,696,42,609,87,6.03,87.5,1.0
06-19-2020,696,42,610,86,6.03,87.64,1.0
06-20-2020,696,42,610,86,6.03,87.64,1.0
06-21-2020,696,42,610,86,6.03,87.64,1.0
06-22-2020,697,42,627,70,6.03,89.96,1.0014367816091954
06-23-2020,698,42,632,66,6.02,90.54,1.0014347202295553
06-24-2020,698,42,647,51,6.02,92.69,1.0
06-25-2020,698,42,653,45,6.02,93.55,1.0
06-26-2020,698,42,656,42,6.02,93.98,1.0
06-27-2020,698,42,656,42,6.02,93.98,1.0
06-28-2020,698,42,656,42,6.02,93.98,1.0
06-29-2020,698,42,656,42,6.02,93.98,1.0
06-30-2020,698,42,656,42,6.02,93.98,1.0
07-01-2020,698,42,656,42,6.02,93.98,1.0
07-02-2020,698,42,656,42,6.02,93.98,1.0
07-03-2020,698,42,656,42,6.02,93.98,1.0
07-04-2020,698,42,656,42,6.02,93.98,1.0
07-05-2020,698,42,656,42,6.02,93.98,1.0
07-06-2020,698,42,656,42,6.02,93.98,1.0
07-07-2020,698,42,656,42,6.02,93.98,1.0
07-08-2020,698,42,656,42,6.02,93.98,1.0
07-09-2020,699,42,656,43,6.01,93.85,1.001432664756447
07-10-2020,699,42,656,43,6.01,93.85,1.0
07-11-2020,699,42,656,43,6.01,93.85,1.0
07-12-2020,699,42,656,43,6.01,93.85,1.0
07-13-2020,699,42,656,43,6.01,93.85,1.0
07-14-2020,699,42,656,43,6.01,93.85,1.0
07-15-2020,699,42,656,43,6.01,93.85,1.0
07-16-2020,699,42,656,43,6.01,93.85,1.0
07-17-2020,699,42,656,43,6.01,93.85,1.0
07-18-2020,699,42,656,43,6.01,93.85,1.0
07-19-2020,699,42,656,43,6.01,93.85,1.0
07-20-2020,699,42,656,43,6.01,93.85,1.0
07-21-2020,699,42,656,43,6.01,93.85,1.0
07-22-2020,699,42,656,43,6.01,93.85,1.0
07-23-2020,699,42,656,43,6.01,93.85,1.0
07-24-2020,699,42,657,42,6.01,93.99,1.0
07-25-2020,699,42,657,42,6.01,93.99,1.0
07-26-2020,699,42,657,42,6.01,93.99,1.0
07-27-2020,699,42,657,42,6.01,93.99,1.0
07-28-2020,699,42,657,42,6.01,93.99,1.0
07-29-2020,699,42,657,42,6.01,93.99,1.0
07-30-2020,699,42,657,42,6.01,93.99,1.0
07-31-2020,699,42,657,42,6.01,93.99,1.0
08-01-2020,699,42,657,42,6.01,93.99,1.0
08-02-2020,699,42,657,42,6.01,93.99,1.0
08-03-2020,699,42,657,42,6.01,93.99,1.0
08-04-2020,699,42,657,42,6.01,93.99,1.0
08-05-2020,699,42,657,42,6.01,93.99,1.0
08-06-2020,699,42,657,42,6.01,93.99,1.0
08-07-2020,699,42,657,42,6.01,93.99,1.0
08-08-2020,699,42,657,42,6.01,93.99,1.0
08-09-2020,699,42,657,42,6.01,93.99,1.0
08-10-2020,699,42,657,42,6.01,93.99,1.0
08-11-2020,699,42,657,42,6.01,93.99,1.0
08-12-2020,699,42,657,42,6.01,93.99,1.0
08-13-2020,699,42,657,42,6.01,93.99,1.0
08-14-2020,699,42,657,42,6.01,93.99,1.0
08-15-2020,699,42,657,42,6.01,93.99,1.0
08-16-2020,699,42,657,42,6.01,93.99,1.0
08-17-2020,699,42,657,42,6.01,93.99,1.0
08-18-2020,702,42,657,45,5.98,93.59,1.0042918454935623
08-19-2020,704,42,657,47,5.97,93.32,1.002849002849003
08-20-2020,704,42,657,47,5.97,93.32,1.0
08-21-2020,704,42,657,47,5.97,93.32,1.0
08-22-2020,704,42,657,47,5.97,93.32,1.0
08-23-2020,704,42,657,47,5.97,93.32,1.0
08-24-2020,704,42,657,47,5.97,93.32,1.0
08-25-2020,710,42,658,52,5.92,92.68,1.0085227272727273
08-26-2020,710,42,658,52,5.92,92.68,1.0
08-27-2020,710,42,658,52,5.92,92.68,1.0
08-28-2020,710,42,658,52,5.92,92.68,1.0
08-29-2020,710,42,658,52,5.92,92.68,1.0
08-30-2020,710,42,658,52,5.92,92.68,1.0
08-31-2020,715,42,660,55,5.87,92.31,1.0070422535211268
09-01-2020,715,42,660,55,5.87,92.31,1.0
09-02-2020,735,42,660,75,5.71,89.8,1.027972027972028
09-03-2020,735,42,660,75,5.71,89.8,1.0
09-04-2020,735,42,660,75,5.71,89.8,1.0
09-05-2020,716,42,660,56,5.87,92.18,1.0258503401360544
09-06-2020,716,42,660,56,5.87,92.18,1.0
09-07-2020,716,42,660,56,5.87,92.18,1.0
09-08-2020,716,42,660,56,5.87,92.18,1.0
09-09-2020,722,42,662,60,5.82,91.69,1.0083798882681565
09-10-2020,722,42,662,60,5.82,91.69,1.0
09-11-2020,722,42,662,60,5.82,91.69,1.0
09-12-2020,722,42,662,60,5.82,91.69,1.0
09-13-2020,722,42,662,60,5.82,91.69,1.0
09-14-2020,722,42,662,60,5.82,91.69,1.0
09-15-2020,723,42,663,60,5.81,91.7,1.0013850415512466
09-16-2020,723,42,663,60,5.81,91.7,1.0
09-17-2020,723,42,663,60,5.81,91.7,1.0
09-18-2020,723,42,669,54,5.81,92.53,1.0
09-19-2020,723,42,669,54,5.81,92.53,1.0
09-20-2020,723,42,669,54,5.81,92.53,1.0
09-21-2020,723,42,669,54,5.81,92.53,1.0
09-22-2020,723,42,669,54,5.81,92.53,1.0
09-23-2020,723,42,669,54,5.81,92.53,1.0
09-24-2020,727,42,676,51,5.78,92.98,1.0055325034578146
09-25-2020,727,42,676,51,5.78,92.98,1.0
09-26-2020,727,42,676,51,5.78,92.98,1.0
09-27-2020,727,42,676,51,5.78,92.98,1.0
09-28-2020,727,42,676,51,5.78,92.98,1.0
09-29-2020,727,42,676,51,5.78,92.98,1.0
09-30-2020,732,42,680,52,5.74,92.9,1.0068775790921596
10-01-2020,732,42,680,52,5.74,92.9,1.0
10-02-2020,732,42,680,52,5.74,92.9,1.0
10-03-2020,732,42,680,52,5.74,92.9,1.0
10-04-2020,732,42,680,52,5.74,92.9,1.0
10-05-2020,732,42,680,52,5.74,92.9,1.0
10-06-2020,732,42,680,52,5.74,92.9,1.0
10-07-2020,732,42,680,52,5.74,92.9,1.0
10-08-2020,741,42,682,59,5.67,92.04,1.0122950819672132
10-09-2020,741,42,682,59,5.67,92.04,1.0
10-10-2020,741,42,682,59,5.67,92.04,1.0
10-11-2020,741,42,682,59,5.67,92.04,1.0
10-12-2020,741,42,682,59,5.67,92.04,1.0
10-13-2020,741,42,682,59,5.67,92.04,1.0
10-14-2020,741,42,682,59,5.67,92.04,1.0
10-15-2020,759,42,685,74,5.53,90.25,1.0242914979757085
10-16-2020,759,42,685,74,5.53,90.25,1.0
10-17-2020,759,42,685,74,5.53,90.25,1.0
10-18-2020,759,42,685,74,5.53,90.25,1.0
10-19-2020,766,42,688,78,5.48,89.82,1.0092226613965745
10-20-2020,766,42,688,78,5.48,89.82,1.0
10-21-2020,774,42,690,84,5.43,89.15,1.010443864229765
10-22-2020,802,42,711,91,5.24,88.65,1.0361757105943152
10-23-2020,819,42,716,103,5.13,87.42,1.0211970074812968
10-24-2020,819,42,716,103,5.13,87.42,1.0
10-25-2020,819,42,716,103,5.13,87.42,1.0
10-26-2020,852,42,716,136,4.93,84.04,1.0402930402930404
10-27-2020,852,42,716,136,4.93,84.04,1.0
10-28-2020,852,42,716,136,4.93,84.04,1.0
10-29-2020,928,42,721,207,4.53,77.69,1.0892018779342723
10-30-2020,928,42,721,207,4.53,77.69,1.0
10-31-2020,928,42,721,207,4.53,77.69,1.0
11-01-2020,928,42,721,207,4.53,77.69,1.0
11-02-2020,928,42,721,207,4.53,77.69,1.0
11-03-2020,994,42,730,264,4.23,73.44,1.0711206896551724
11-04-2020,994,42,730,264,4.23,73.44,1.0
11-05-2020,1043,42,754,289,4.03,72.29,1.0492957746478873
11-06-2020,1043,42,754,289,4.03,72.29,1.0
11-07-2020,1043,42,754,289,4.03,72.29,1.0
11-08-2020,1043,42,754,289,4.03,72.29,1.0
11-09-2020,1114,42,789,325,3.77,70.83,1.0680728667305848
11-10-2020,1114,42,789,325,3.77,70.83,1.0
11-11-2020,1190,42,857,333,3.53,72.02,1.0682226211849193
11-12-2020,1190,42,857,333,3.53,72.02,1.0
11-13-2020,1253,42,888,365,3.35,70.87,1.0529411764705883
11-14-2020,1253,42,888,365,3.35,70.87,1.0
11-15-2020,1253,42,888,365,3.35,70.87,1.0
11-16-2020,1290,42,920,370,3.26,71.32,1.0295291300877893
11-17-2020,1290,42,920,370,3.26,71.32,1.0
11-18-2020,1358,43,1019,339,3.17,75.04,1.0527131782945736
11-19-2020,1358,43,1019,339,3.17,75.04,1.0
11-20-2020,1395,43,1082,313,3.08,77.56,1.0272459499263622
11-21-2020,1395,43,1082,313,3.08,77.56,1.0
11-22-2020,1395,43,1082,313,3.08,77.56,1.0
11-23-2020,1428,44,1149,279,3.08,80.46,1.0236559139784946
11-24-2020,1428,44,1149,279,3.08,80.46,1.0
11-25-2020,1492,44,1221,271,2.95,81.84,1.0448179271708684
11-26-2020,1514,44,1231,283,2.91,81.31,1.0147453083109919
11-27-2020,1554,44,1252,302,2.83,80.57,1.0264200792602378
11-28-2020,1586,45,1285,301,2.84,81.02,1.0205920205920207
11-29-2020,1586,45,1285,301,2.84,81.02,1.0
11-30-2020,1612,46,1299,313,2.85,80.58,1.0163934426229508
12-01-2020,1650,46,1334,316,2.79,80.85,1.0235732009925558
12-02-2020,1687,46,1340,347,2.73,79.43,1.0224242424242425
12-03-2020,1714,46,1356,358,2.68,79.11,1.016004742145821
12-04-2020,1756,47,1381,375,2.68,78.64,1.0245040840140023
12-05-2020,1789,48,1412,377,2.68,78.93,1.0187927107061503
12-06-2020,1789,48,1412,377,2.68,78.93,1.0
12-07-2020,1800,48,1438,362,2.67,79.89,1.0061486864169928
12-08-2020,1800,48,1438,362,2.67,79.89,1.0
12-09-2020,1834,49,1492,342,2.67,81.35,1.018888888888889
12-10-2020,1868,49,1524,344,2.62,81.58,1.0185387131952017
12-11-2020,1908,50,1555,353,2.62,81.5,1.0214132762312633
12-12-2020,1932,51,1575,357,2.64,81.52,1.0125786163522013
12-13-2020,1932,51,1575,357,2.64,81.52,1.0
12-14-2020,1934,51,1608,326,2.64,83.14,1.0010351966873705
12-15-2020,1982,52,1685,297,2.62,85.02,1.0248190279214064
12-16-2020,2025,54,1694,331,2.67,83.65,1.0216952573158427
12-17-2020,2049,54,1703,346,2.64,83.11,1.0118518518518518
12-18-2020,2072,55,1733,339,2.65,83.64,1.0112249877989263
12-19-2020,2107,55,1736,371,2.61,82.39,1.0168918918918919
12-20-2020,2107,55,1736,371,2.61,82.39,1.0
12-21-2020,2135,55,1767,368,2.58,82.76,1.0132890365448506
12-22-2020,2176,56,1825,351,2.57,83.87,1.0192037470725994
12-23-2020,2205,56,1846,359,2.54,83.72,1.013327205882353
12-24-2020,2231,56,1863,368,2.51,83.51,1.0117913832199545
12-25-2020,2231,56,1863,368,2.51,83.51,1.0
12-26-2020,2231,56,1863,368,2.51,83.51,1.0
12-27-2020,2231,56,1863,368,2.51,83.51,1.0
12-28-2020,2275,57,1955,320,2.51,85.93,1.0197220977140296
12-29-2020,2333,59,2010,323,2.53,86.16,1.0254945054945055
12-30-2020,2384,59,2035,349,2.47,85.36,1.0218602657522504
12-31-2020,2428,59,2042,386,2.43,84.1,1.0184563758389262
01-01-2021,2428,59,2042,386,2.43,84.1,1.0
01-02-2021,2428,59,2042,386,2.43,84.1,1.0
01-03-2021,2428,59,2042,386,2.43,84.1,1.0
01-04-2021,2493,62,2127,366,2.49,85.32,1.0267710049423393
01-05-2021,2549,62,2158,391,2.43,84.66,1.0224628961091056
01-06-2021,2549,62,2158,391,2.43,84.66,1.0
01-07-2021,2583,64,2179,404,2.48,84.36,1.013338564142801
01-08-2021,2628,64,2220,408,2.44,84.47,1.0174216027874565
01-09-2021,2628,64,2220,408,2.44,84.47,1.0
01-10-2021,2628,64,2220,408,2.44,84.47,1.0
01-11-2021,2667,64,2297,370,2.4,86.13,1.014840182648402
01-12-2021,2706,65,2333,373,2.4,86.22,1.014623172103487
01-13-2021,2723,65,2373,350,2.39,87.15,1.0062823355506283
01-14-2021,2737,65,2381,356,2.37,86.99,1.0051413881748072
01-15-2021,2767,65,2430,337,2.35,87.82,1.010960906101571
01-16-2021,2778,65,2455,323,2.34,88.37,1.003975424647633
01-17-2021,2778,65,2455,323,2.34,88.37,1.0
01-18-2021,2787,65,2464,323,2.33,88.41,1.0032397408207343
01-19-2021,2803,65,2530,273,2.32,90.26,1.0057409400789379
01-20-2021,2815,65,2548,267,2.31,90.52,1.004281127363539
01-21-2021,2833,65,2556,277,2.29,90.22,1.0063943161634104
01-22-2021,2861,65,2597,264,2.27,90.77,1.0098835157077304
01-23-2021,2874,65,2615,259,2.26,90.99,1.0045438657811954
01-24-2021,2874,65,2615,259,2.26,90.99,1.0
01-25-2021,2889,65,2628,261,2.25,90.97,1.0052192066805845
01-26-2021,2915,65,2660,255,2.23,91.25,1.008999653859467
01-27-2021,2941,65,2675,266,2.21,90.96,1.0089193825042881
01-28-2021,2969,65,2684,285,2.19,90.4,1.009520571234274
01-29-2021,2996,65,2695,301,2.17,89.95,1.009093971034018
01-30-2021,2996,65,2695,301,2.17,89.95,1.0
01-31-2021,3025,67,2723,302,2.21,90.02,1.009679572763685
02-01-2021,3025,67,2723,302,2.21,90.02,1.0
02-02-2021,3066,67,2752,314,2.19,89.76,1.0135537190082644
02-03-2021,3094,68,2773,321,2.2,89.63,1.009132420091324
02-04-2021,3111,68,2774,337,2.19,89.17,1.0054945054945055
02-05-2021,3111,68,2774,337,2.19,89.17,1.0
02-06-2021,3127,69,2795,332,2.21,89.38,1.0051430408228865
02-07-2021,3127,69,2795,332,2.21,89.38,1.0
02-08-2021,3137,69,2835,302,2.2,90.37,1.0031979533098816
02-09-2021,3187,71,2886,301,2.23,90.56,1.015938795027096
02-10-2021,3213,71,2897,316,2.21,90.16,1.0081581424537183
02-11-2021,3247,72,2918,329,2.22,89.87,1.0105820105820107
02-12-2021,3278,72,2956,322,2.2,90.18,1.009547274407145
02-13-2021,3278,72,2956,322,2.2,90.18,1.0
02-14-2021,3278,72,2956,322,2.2,90.18,1.0
02-15-2021,3317,72,2993,324,2.17,90.23,1.0118974984746796
02-16-2021,3352,72,3009,343,2.15,89.77,1.0105517033463973
02-17-2021,3394,72,3028,366,2.12,89.22,1.0125298329355608
02-18-2021,3420,72,3035,385,2.11,88.74,1.0076605774896876
02-19-2021,3440,72,3070,370,2.09,89.24,1.0058479532163742
02-20-2021,3472,72,3092,380,2.07,89.06,1.0093023255813953
02-21-2021,3472,72,3092,380,2.07,89.06,1.0
02-22-2021,3494,72,3115,379,2.06,89.15,1.006336405529954
02-23-2021,3538,73,3167,371,2.06,89.51,1.0125930165998855
02-24-2021,3585,73,3195,390,2.04,89.12,1.0132843414358395
02-25-2021,3621,73,3201,420,2.02,88.4,1.010041841004184
02-26-2021,3671,73,3224,447,1.99,87.82,1.0138083402375035
02-27-2021,3716,74,3257,459,1.99,87.65,1.0122582402615092
02-28-2021,3716,74,3257,459,1.99,87.65,1.0
03-01-2021,3746,74,3276,470,1.98,87.45,1.0080731969860064
03-02-2021,3791,74,3325,466,1.95,87.71,1.0120128136679125
03-03-2021,3829,75,3345,484,1.96,87.36,1.0100237404378791
03-04-2021,3867,75,3361,506,1.94,86.91,1.0099242622094542
03-05-2021,3896,76,3386,510,1.95,86.91,1.0074993535040082
03-06-2021,3922,76,3426,496,1.94,87.35,1.0066735112936345
03-07-2021,3922,76,3426,496,1.94,87.35,1.0
03-08-2021,3935,76,3434,501,1.93,87.27,1.003314635390107
03-09-2021,3984,77,3457,527,1.93,86.77,1.0124523506988563
03-10-2021,4030,77,3477,553,1.91,86.28,1.0115461847389557
03-11-2021,4062,77,3511,551,1.9,86.44,1.007940446650124
03-12-2021,4096,77,3550,546,1.88,86.67,1.0083702609551946
03-13-2021,4126,77,3594,532,1.87,87.11,1.00732421875
03-14-2021,4126,77,3594,532,1.87,87.11,1.0
03-15-2021,4151,77,3624,527,1.85,87.3,1.0060591371788656
03-16-2021,4204,77,3691,513,1.83,87.8,1.0127680077089858
03-17-2021,4249,77,3729,520,1.81,87.76,1.0107040913415795
03-18-2021,4292,78,3758,534,1.82,87.56,1.0101200282419394
03-19-2021,4328,79,3786,542,1.83,87.48,1.0083876980428705
03-20-2021,4356,79,3805,551,1.81,87.35,1.0064695009242144
03-21-2021,4356,79,3805,551,1.81,87.35,1.0
03-22-2021,4388,79,3819,569,1.8,87.03,1.007346189164371
03-23-2021,4432,80,3874,558,1.81,87.41,1.0100273473108479
