date,total_confirmed,total_deaths,total_recovered,total_infected,mortality_rate,recovery_rate,daily_growth_rate
02-27-2020,0,0,0,0,0,0,1
02-28-2020,0,0,0,0,0,0,1
02-29-2020,1,1,0,1,100.0,0,1
03-01-2020,1,1,0,1,100.0,0,1.0
03-02-2020,1,1,0,1,100.0,0,1.0
03-03-2020,9,1,0,9,11.11,0,9.0
03-04-2020,9,1,0,9,11.11,0,1.0
03-05-2020,16,1,0,16,6.25,0,1.7777777777777777
03-06-2020,22,1,0,22,4.55,0,1.375
03-07-2020,24,1,0,24,4.17,0,1.0909090909090908
03-08-2020,27,1,0,27,3.7,0,1.125
03-09-2020,37,1,0,37,2.7,0,1.3703703703703702
03-10-2020,49,2,0,49,4.08,0,1.3243243243243243
03-11-2020,60,2,0,60,3.33,0,1.2244897959183674
03-12-2020,60,2,0,60,3.33,0,1.0
03-13-2020,64,5,0,64,7.81,0,1.0666666666666667
03-14-2020,77,5,4,73,6.49,5.19,1.203125
03-15-2020,77,5,4,73,6.49,5.19,1.0
03-16-2020,77,5,4,73,6.49,5.19,1.0
03-17-2020,102,9,4,98,8.82,3.92,1.3246753246753247
03-18-2020,104,11,4,100,10.58,3.85,1.0196078431372548
03-19-2020,109,14,4,105,12.84,3.67,1.0480769230769231
03-20-2020,126,14,4,122,11.11,3.17,1.1559633027522935
03-21-2020,151,20,4,147,13.25,2.65,1.1984126984126984
03-22-2020,175,20,4,171,11.43,2.29,1.1589403973509933
03-23-2020,187,20,4,183,10.7,2.14,1.0685714285714285
03-24-2020,187,21,4,183,11.23,2.14,1.0
03-25-2020,208,21,4,204,10.1,1.92,1.1122994652406417
03-26-2020,218,21,4,214,9.63,1.83,1.0480769230769231
03-27-2020,223,21,4,219,9.42,1.79,1.0229357798165137
03-28-2020,228,22,6,222,9.65,2.63,1.0224215246636772
03-29-2020,228,22,6,222,9.65,2.63,1.0
03-30-2020,230,25,13,217,10.87,5.65,1.0087719298245614
03-31-2020,236,26,13,223,11.02,5.51,1.0260869565217392
04-01-2020,236,28,13,223,11.86,5.51,1.0
04-02-2020,236,28,21,215,11.86,8.9,1.0
04-03-2020,245,30,21,224,12.24,8.57,1.0381355932203389
04-04-2020,252,32,27,225,12.7,10.71,1.0285714285714285
04-05-2020,259,32,35,224,12.36,13.51,1.0277777777777777
04-06-2020,266,32,35,231,12.03,13.16,1.027027027027027
04-07-2020,277,32,40,237,11.55,14.44,1.0413533834586466
04-08-2020,279,34,40,239,12.19,14.34,1.0072202166064983
04-09-2020,308,34,49,259,11.04,15.91,1.103942652329749
04-10-2020,344,34,50,294,9.88,14.53,1.1168831168831168
04-11-2020,344,34,53,291,9.88,15.41,1.0
04-12-2020,356,35,53,303,9.83,14.89,1.0348837209302326
04-13-2020,356,35,53,303,9.83,14.89,1.0
04-14-2020,371,36,53,318,9.7,14.29,1.0421348314606742
04-15-2020,372,36,53,319,9.68,14.25,1.0026954177897573
04-16-2020,393,36,55,338,9.16,13.99,1.0564516129032258
04-17-2020,426,38,57,369,8.92,13.38,1.083969465648855
04-18-2020,426,38,60,366,8.92,14.08,1.0
04-19-2020,455,39,60,395,8.57,13.19,1.068075117370892
04-20-2020,461,39,61,400,8.46,13.23,1.0131868131868131
04-21-2020,462,39,62,400,8.44,13.42,1.002169197396963
04-22-2020,476,40,62,414,8.4,13.03,1.0303030303030303
04-23-2020,488,40,63,425,8.2,12.91,1.0252100840336134
04-24-2020,501,40,64,437,7.98,12.77,1.026639344262295
04-25-2020,513,40,64,449,7.8,12.48,1.0239520958083832
04-26-2020,513,40,64,449,7.8,12.48,1.0
04-27-2020,538,41,64,474,7.62,11.9,1.0487329434697856
04-28-2020,538,41,64,474,7.62,11.9,1.0
04-29-2020,553,41,69,484,7.41,12.48,1.0278810408921932
04-30-2020,563,41,78,485,7.28,13.85,1.0180831826401446
05-01-2020,569,41,82,487,7.21,14.41,1.0106571936056838
05-02-2020,580,41,83,497,7.07,14.31,1.0193321616871704
05-03-2020,580,41,86,494,7.07,14.83,1.0
05-04-2020,582,41,86,496,7.04,14.78,1.0034482758620689
05-05-2020,582,41,92,490,7.04,15.81,1.0
05-06-2020,589,41,97,492,6.96,16.47,1.0120274914089347
05-07-2020,608,41,106,502,6.74,17.43,1.032258064516129
05-08-2020,632,41,114,518,6.49,18.04,1.0394736842105263
05-09-2020,632,41,126,506,6.49,19.94,1.0
05-10-2020,632,41,126,506,6.49,19.94,1.0
05-11-2020,637,41,130,507,6.44,20.41,1.0079113924050633
05-12-2020,647,41,161,486,6.34,24.88,1.0156985871271587
05-13-2020,647,41,161,486,6.34,24.88,1.0
05-14-2020,647,41,172,475,6.34,26.58,1.0
05-15-2020,647,41,189,458,6.34,29.21,1.0
05-16-2020,652,41,198,454,6.29,30.37,1.007727975270479
05-17-2020,652,41,201,451,6.29,30.83,1.0
05-18-2020,668,41,203,465,6.14,30.39,1.0245398773006136
05-19-2020,668,41,211,457,6.14,31.59,1.0
05-20-2020,668,41,220,448,6.14,32.93,1.0
05-21-2020,670,41,235,435,6.12,35.07,1.0029940119760479
05-22-2020,672,41,254,418,6.1,37.8,1.0029850746268656
05-23-2020,672,41,266,406,6.1,39.58,1.0
05-24-2020,672,42,266,406,6.25,39.58,1.0
05-25-2020,672,42,270,402,6.25,40.18,1.0
05-26-2020,672,42,275,397,6.25,40.92,1.0
05-27-2020,672,42,294,378,6.25,43.75,1.0
05-28-2020,672,42,322,350,6.25,47.92,1.0
05-29-2020,687,42,344,343,6.11,50.07,1.0223214285714286
05-30-2020,687,42,357,330,6.11,51.97,1.0
05-31-2020,687,42,357,330,6.11,51.97,1.0
06-01-2020,687,42,359,328,6.11,52.26,1.0
06-02-2020,687,42,384,303,6.11,55.9,1.0
06-03-2020,687,42,391,296,6.11,56.91,1.0
06-04-2020,687,42,408,279,6.11,59.39,1.0
06-05-2020,695,42,428,267,6.04,61.58,1.0116448326055314
06-06-2020,695,42,428,267,6.04,61.58,1.0
06-07-2020,695,42,428,267,6.04,61.58,1.0
06-08-2020,695,42,478,217,6.04,68.78,1.0
06-09-2020,695,42,483,212,6.04,69.5,1.0
06-10-2020,695,42,496,199,6.04,71.37,1.0
06-11-2020,695,42,496,199,6.04,71.37,1.0
06-12-2020,695,42,520,175,6.04,74.82,1.0
06-13-2020,695,42,520,175,6.04,74.82,1.0
06-14-2020,695,42,520,175,6.04,74.82,1.0
06-15-2020,695,42,575,120,6.04,82.73,1.0
06-16-2020,695,42,590,105,6.04,84.89,1.0
06-17-2020,695,42,591,104,6.04,85.04,1.0
06-18-2020,709,42,609,100,5.92,85.9,1.0201438848920863
06-19-2020,709,42,610,99,5.92,86.04,1.0
06-20-2020,713,42,610,103,5.89,85.55,1.005641748942172
06-21-2020,713,42,610,103,5.89,85.55,1.0
06-22-2020,713,42,627,86,5.89,87.94,1.0
06-23-2020,713,42,632,81,5.89,88.64,1.0
06-24-2020,713,42,647,66,5.89,90.74,1.0
06-25-2020,713,42,653,60,5.89,91.58,1.0
06-26-2020,713,42,656,57,5.89,92.01,1.0
06-27-2020,713,42,656,57,5.89,92.01,1.0
06-28-2020,713,42,656,57,5.89,92.01,1.0
06-29-2020,713,42,656,57,5.89,92.01,1.0
06-30-2020,713,42,656,57,5.89,92.01,1.0
07-01-2020,713,42,656,57,5.89,92.01,1.0
07-02-2020,713,42,656,57,5.89,92.01,1.0
07-03-2020,713,42,656,57,5.89,92.01,1.0
07-04-2020,713,42,656,57,5.89,92.01,1.0
07-05-2020,713,42,656,57,5.89,92.01,1.0
07-06-2020,713,42,656,57,5.89,92.01,1.0
07-07-2020,713,42,656,57,5.89,92.01,1.0
07-08-2020,713,42,656,57,5.89,92.01,1.0
07-09-2020,713,42,656,57,5.89,92.01,1.0
07-10-2020,716,42,656,60,5.87,91.62,1.0042075736325387
07-11-2020,716,42,656,60,5.87,91.62,1.0
07-12-2020,716,42,656,60,5.87,91.62,1.0
07-13-2020,716,42,656,60,5.87,91.62,1.0
07-14-2020,716,42,656,60,5.87,91.62,1.0
07-15-2020,716,42,656,60,5.87,91.62,1.0
07-16-2020,716,42,656,60,5.87,91.62,1.0
07-17-2020,716,42,656,60,5.87,91.62,1.0
07-18-2020,716,42,656,60,5.87,91.62,1.0
07-19-2020,716,42,656,60,5.87,91.62,1.0
07-20-2020,716,42,656,60,5.87,91.62,1.0
07-21-2020,716,42,656,60,5.87,91.62,1.0
07-22-2020,716,42,656,60,5.87,91.62,1.0
07-23-2020,716,42,656,60,5.87,91.62,1.0
07-24-2020,716,42,657,59,5.87,91.76,1.0
07-25-2020,716,42,657,59,5.87,91.76,1.0
07-26-2020,716,42,657,59,5.87,91.76,1.0
07-27-2020,716,42,657,59,5.87,91.76,1.0
07-28-2020,716,42,657,59,5.87,91.76,1.0
07-29-2020,716,42,657,59,5.87,91.76,1.0
07-30-2020,716,42,657,59,5.87,91.76,1.0
07-31-2020,716,42,657,59,5.87,91.76,1.0
08-01-2020,716,42,657,59,5.87,91.76,1.0
08-02-2020,716,42,657,59,5.87,91.76,1.0
08-03-2020,716,42,657,59,5.87,91.76,1.0
08-04-2020,716,42,657,59,5.87,91.76,1.0
08-05-2020,716,42,657,59,5.87,91.76,1.0
08-06-2020,716,42,657,59,5.87,91.76,1.0
08-07-2020,717,42,657,60,5.86,91.63,1.0013966480446927
08-08-2020,717,42,657,60,5.86,91.63,1.0
08-09-2020,717,42,657,60,5.86,91.63,1.0
08-10-2020,717,42,657,60,5.86,91.63,1.0
08-11-2020,717,42,657,60,5.86,91.63,1.0
08-12-2020,719,42,657,62,5.84,91.38,1.00278940027894
08-13-2020,719,42,657,62,5.84,91.38,1.0
08-14-2020,719,42,657,62,5.84,91.38,1.0
08-15-2020,719,42,657,62,5.84,91.38,1.0
08-16-2020,719,42,657,62,5.84,91.38,1.0
08-17-2020,719,42,657,62,5.84,91.38,1.0
08-18-2020,719,42,657,62,5.84,91.38,1.0
08-19-2020,719,42,657,62,5.84,91.38,1.0
08-20-2020,719,42,657,62,5.84,91.38,1.0
08-21-2020,726,42,657,69,5.79,90.5,1.0097357440890125
08-22-2020,726,42,657,69,5.79,90.5,1.0
08-23-2020,726,42,657,69,5.79,90.5,1.0
08-24-2020,726,42,657,69,5.79,90.5,1.0
08-25-2020,726,42,658,68,5.79,90.63,1.0
08-26-2020,730,42,658,72,5.75,90.14,1.0055096418732783
08-27-2020,730,42,658,72,5.75,90.14,1.0
08-28-2020,732,42,658,74,5.74,89.89,1.0027397260273974
08-29-2020,733,42,658,75,5.73,89.77,1.0013661202185793
08-30-2020,733,42,658,75,5.73,89.77,1.0
08-31-2020,735,42,660,75,5.71,89.8,1.0027285129604366
09-01-2020,735,42,660,75,5.71,89.8,1.0
09-02-2020,735,42,660,75,5.71,89.8,1.0
09-03-2020,735,42,660,75,5.71,89.8,1.0
09-04-2020,735,42,660,75,5.71,89.8,1.0
09-05-2020,735,42,660,75,5.71,89.8,1.0
09-06-2020,735,42,660,75,5.71,89.8,1.0
09-07-2020,735,42,660,75,5.71,89.8,1.0
09-08-2020,735,42,660,75,5.71,89.8,1.0
09-09-2020,735,42,662,73,5.71,90.07,1.0
09-10-2020,735,42,662,73,5.71,90.07,1.0
09-11-2020,741,42,662,79,5.67,89.34,1.0081632653061225
09-12-2020,741,42,662,79,5.67,89.34,1.0
09-13-2020,741,42,662,79,5.67,89.34,1.0
09-14-2020,741,42,662,79,5.67,89.34,1.0
09-15-2020,741,42,663,78,5.67,89.47,1.0
09-16-2020,741,42,663,78,5.67,89.47,1.0
09-17-2020,742,42,663,79,5.66,89.35,1.001349527665317
09-18-2020,742,42,669,73,5.66,90.16,1.0
09-19-2020,742,42,669,73,5.66,90.16,1.0
09-20-2020,742,42,669,73,5.66,90.16,1.0
09-21-2020,742,42,669,73,5.66,90.16,1.0
09-22-2020,742,42,669,73,5.66,90.16,1.0
09-23-2020,742,42,669,73,5.66,90.16,1.0
09-24-2020,746,42,676,70,5.63,90.62,1.005390835579515
09-25-2020,746,42,676,70,5.63,90.62,1.0
09-26-2020,746,42,676,70,5.63,90.62,1.0
09-27-2020,746,42,676,70,5.63,90.62,1.0
09-28-2020,746,42,676,70,5.63,90.62,1.0
09-29-2020,749,42,676,73,5.61,90.25,1.0040214477211795
09-30-2020,749,42,680,69,5.61,90.79,1.0
10-01-2020,750,42,680,70,5.6,90.67,1.0013351134846462
10-02-2020,750,42,680,70,5.6,90.67,1.0
10-03-2020,750,42,680,70,5.6,90.67,1.0
10-04-2020,750,42,680,70,5.6,90.67,1.0
10-05-2020,750,42,680,70,5.6,90.67,1.0
10-06-2020,751,42,680,71,5.59,90.55,1.0013333333333334
10-07-2020,751,42,680,71,5.59,90.55,1.0
10-08-2020,752,42,682,70,5.59,90.69,1.0013315579227697
10-09-2020,752,42,682,70,5.59,90.69,1.0
10-10-2020,766,42,682,84,5.48,89.03,1.0186170212765957
10-11-2020,766,42,682,84,5.48,89.03,1.0
10-12-2020,766,42,682,84,5.48,89.03,1.0
10-13-2020,766,42,682,84,5.48,89.03,1.0
10-14-2020,772,42,682,90,5.44,88.34,1.0078328981723237
10-15-2020,772,42,685,87,5.44,88.73,1.0
10-16-2020,781,42,685,96,5.38,87.71,1.011658031088083
10-17-2020,784,42,685,99,5.36,87.37,1.0038412291933418
10-18-2020,784,42,685,99,5.36,87.37,1.0
10-19-2020,784,42,688,96,5.36,87.76,1.0
10-20-2020,789,42,688,101,5.32,87.2,1.0063775510204083
10-21-2020,794,42,690,104,5.29,86.9,1.0063371356147022
10-22-2020,796,42,711,85,5.28,89.32,1.0025188916876575
10-23-2020,802,42,716,86,5.24,89.28,1.0075376884422111
10-24-2020,819,42,716,103,5.13,87.42,1.0211970074812968
10-25-2020,844,42,716,128,4.98,84.83,1.0305250305250304
10-26-2020,844,42,716,128,4.98,84.83,1.0
10-27-2020,852,42,716,136,4.93,84.04,1.009478672985782
10-28-2020,883,42,716,167,4.76,81.09,1.0363849765258215
10-29-2020,903,42,721,182,4.65,79.84,1.0226500566251415
10-30-2020,929,42,721,208,4.52,77.61,1.0287929125138426
10-31-2020,958,42,721,237,4.38,75.26,1.031216361679225
11-01-2020,958,42,721,237,4.38,75.26,1.0
11-02-2020,958,42,721,237,4.38,75.26,1.0
11-03-2020,958,42,730,228,4.38,76.2,1.0
11-04-2020,994,42,730,264,4.23,73.44,1.0375782881002087
11-05-2020,1002,42,754,248,4.19,75.25,1.0080482897384306
11-06-2020,1043,42,754,289,4.03,72.29,1.0409181636726548
11-07-2020,1101,42,754,347,3.81,68.48,1.0556088207094918
11-08-2020,1101,42,754,347,3.81,68.48,1.0
11-09-2020,1101,42,789,312,3.81,71.66,1.0
11-10-2020,1114,42,789,325,3.77,70.83,1.0118074477747503
11-11-2020,1155,42,857,298,3.64,74.2,1.0368043087971275
11-12-2020,1190,42,857,333,3.53,72.02,1.0303030303030303
11-13-2020,1234,42,888,346,3.4,71.96,1.0369747899159665
11-14-2020,1253,42,888,365,3.35,70.87,1.0153970826580228
11-15-2020,1253,42,888,365,3.35,70.87,1.0
11-16-2020,1290,42,920,370,3.26,71.32,1.0295291300877893
11-17-2020,1290,42,920,370,3.26,71.32,1.0
11-18-2020,1321,43,1019,302,3.26,77.14,1.024031007751938
11-19-2020,1358,43,1019,339,3.17,75.04,1.028009084027252
11-20-2020,1373,43,1082,291,3.13,78.81,1.0110456553755522
11-21-2020,1395,43,1082,313,3.08,77.56,1.0160233066278224
11-22-2020,1427,43,1082,345,3.01,75.82,1.0229390681003585
11-23-2020,1428,44,1149,279,3.08,80.46,1.0007007708479327
11-24-2020,1428,44,1149,279,3.08,80.46,1.0
11-25-2020,1454,44,1221,233,3.03,83.98,1.0182072829131652
11-26-2020,1492,44,1231,261,2.95,82.51,1.0261348005502062
11-27-2020,1514,44,1252,262,2.91,82.69,1.0147453083109919
11-28-2020,1554,44,1285,269,2.83,82.69,1.0264200792602378
11-29-2020,1586,45,1285,301,2.84,81.02,1.0205920205920207
11-30-2020,1609,45,1299,310,2.8,80.73,1.014501891551072
12-01-2020,1612,46,1334,278,2.85,82.75,1.0018645121193288
12-02-2020,1650,46,1340,310,2.79,81.21,1.0235732009925558
12-03-2020,1687,46,1356,331,2.73,80.38,1.0224242424242425
12-04-2020,1714,46,1381,333,2.68,80.57,1.016004742145821
12-05-2020,1756,47,1412,344,2.68,80.41,1.0245040840140023
12-06-2020,1789,48,1412,377,2.68,78.93,1.0187927107061503
12-07-2020,1789,48,1438,351,2.68,80.38,1.0
12-08-2020,1800,48,1438,362,2.67,79.89,1.0061486864169928
12-09-2020,1832,48,1492,340,2.62,81.44,1.0177777777777777
12-10-2020,1834,49,1524,310,2.67,83.1,1.0010917030567685
12-11-2020,1868,49,1555,313,2.62,83.24,1.0185387131952017
12-12-2020,1908,50,1575,333,2.62,82.55,1.0214132762312633
12-13-2020,1932,51,1575,357,2.64,81.52,1.0125786163522013
12-14-2020,1947,51,1608,339,2.62,82.59,1.0077639751552796
12-15-2020,1982,52,1685,297,2.62,85.02,1.0179763739085772
12-16-2020,2025,54,1694,331,2.67,83.65,1.0216952573158427
12-17-2020,2025,54,1703,322,2.67,84.1,1.0
12-18-2020,2049,54,1733,316,2.64,84.58,1.0118518518518518
12-19-2020,2049,55,1736,313,2.68,84.72,1.0
12-20-2020,2107,55,1736,371,2.61,82.39,1.0283064909712054
12-21-2020,2107,55,1767,340,2.61,83.86,1.0
12-22-2020,2135,55,1825,310,2.58,85.48,1.0132890365448506
12-23-2020,2176,56,1846,330,2.57,84.83,1.0192037470725994
12-24-2020,2206,56,1863,343,2.54,84.45,1.0137867647058822
12-25-2020,2231,56,1863,368,2.51,83.51,1.0113327289211242
12-26-2020,2264,57,1863,401,2.52,82.29,1.0147915732855222
12-27-2020,2264,57,1863,401,2.52,82.29,1.0
12-28-2020,2276,57,1955,321,2.5,85.9,1.0053003533568905
12-29-2020,2276,57,2010,266,2.5,88.31,1.0
12-30-2020,2333,59,2035,298,2.53,87.23,1.0250439367311073
12-31-2020,2333,59,2042,291,2.53,87.53,1.0
01-01-2021,2384,59,2042,342,2.47,85.65,1.0218602657522504
01-02-2021,2428,59,2042,386,2.43,84.1,1.0184563758389262
01-03-2021,2463,61,2042,421,2.48,82.91,1.0144151565074135
01-04-2021,2463,61,2127,336,2.48,86.36,1.0
01-05-2021,2493,62,2158,335,2.49,86.56,1.0121802679658953
01-06-2021,2549,62,2158,391,2.43,84.66,1.0224628961091056
01-07-2021,2549,62,2179,370,2.43,85.48,1.0
01-08-2021,2583,64,2220,363,2.48,85.95,1.013338564142801
01-09-2021,2628,64,2220,408,2.44,84.47,1.0174216027874565
01-10-2021,2650,64,2220,430,2.42,83.77,1.008371385083714
01-11-2021,2650,64,2297,353,2.42,86.68,1.0
01-12-2021,2650,64,2333,317,2.42,88.04,1.0
01-13-2021,2706,65,2373,333,2.4,87.69,1.0211320754716982
01-14-2021,2723,65,2381,342,2.39,87.44,1.0062823355506283
01-15-2021,2738,65,2430,308,2.37,88.75,1.0055086301872935
01-16-2021,2767,65,2455,312,2.35,88.72,1.0105916727538349
01-17-2021,2778,65,2455,323,2.34,88.37,1.003975424647633
01-18-2021,2778,65,2464,314,2.34,88.7,1.0
01-19-2021,2787,65,2530,257,2.33,90.78,1.0032397408207343
01-20-2021,2787,65,2548,239,2.33,91.42,1.0
01-21-2021,2815,65,2556,259,2.31,90.8,1.0100466451381414
01-22-2021,2833,65,2597,236,2.29,91.67,1.0063943161634104
01-23-2021,2861,65,2615,246,2.27,91.4,1.0098835157077304
01-24-2021,2874,65,2615,259,2.26,90.99,1.0045438657811954
01-25-2021,2874,65,2628,246,2.26,91.44,1.0
01-26-2021,2889,65,2660,229,2.25,92.07,1.0052192066805845
01-27-2021,2915,65,2675,240,2.23,91.77,1.008999653859467
01-28-2021,2941,65,2684,257,2.21,91.26,1.0089193825042881
01-29-2021,2969,65,2695,274,2.19,90.77,1.009520571234274
01-30-2021,2996,65,2695,301,2.17,89.95,1.009093971034018
01-31-2021,3025,67,2723,302,2.21,90.02,1.009679572763685
02-01-2021,3025,67,2723,302,2.21,90.02,1.0
02-02-2021,3066,67,2752,314,2.19,89.76,1.0135537190082644
02-03-2021,3094,68,2773,321,2.2,89.63,1.009132420091324
02-04-2021,3111,68,2774,337,2.19,89.17,1.0054945054945055
02-05-2021,3125,68,2774,351,2.18,88.77,1.0045001607200257
02-06-2021,3127,69,2795,332,2.21,89.38,1.00064
02-07-2021,3136,69,2795,341,2.2,89.13,1.0028781579788935
02-08-2021,3137,69,2835,302,2.2,90.37,1.0003188775510203
02-09-2021,3137,69,2886,251,2.2,92.0,1.0
02-10-2021,3187,71,2897,290,2.23,90.9,1.015938795027096
02-11-2021,3213,71,2918,295,2.21,90.82,1.0081581424537183
02-12-2021,3247,72,2956,291,2.22,91.04,1.0105820105820107
02-13-2021,3278,72,2956,322,2.2,90.18,1.009547274407145
02-14-2021,3304,72,2956,348,2.18,89.47,1.0079316656497865
02-15-2021,3314,72,2993,321,2.17,90.31,1.0030266343825667
02-16-2021,3317,72,3009,308,2.17,90.71,1.0009052504526252
02-17-2021,3352,72,3028,324,2.15,90.33,1.0105517033463973
02-18-2021,3394,72,3035,359,2.12,89.42,1.0125298329355608
02-19-2021,3420,72,3070,350,2.11,89.77,1.0076605774896876
02-20-2021,3440,72,3092,348,2.09,89.88,1.0058479532163742
02-21-2021,3472,72,3092,380,2.07,89.06,1.0093023255813953
02-22-2021,3492,72,3115,377,2.06,89.2,1.0057603686635945
02-23-2021,3494,72,3167,327,2.06,90.64,1.0005727376861397
02-24-2021,3538,73,3195,343,2.06,90.31,1.0125930165998855
02-25-2021,3585,73,3201,384,2.04,89.29,1.0132843414358395
02-26-2021,3621,73,3224,397,2.02,89.04,1.010041841004184
02-27-2021,3671,73,3257,414,1.99,88.72,1.0138083402375035
02-28-2021,3716,74,3257,459,1.99,87.65,1.0122582402615092
03-01-2021,3716,74,3276,440,1.99,88.16,1.0
03-02-2021,3746,74,3325,421,1.98,88.76,1.0080731969860064
03-03-2021,3791,74,3345,446,1.95,88.24,1.0120128136679125
03-04-2021,3829,75,3361,468,1.96,87.78,1.0100237404378791
03-05-2021,3867,75,3386,481,1.94,87.56,1.0099242622094542
03-06-2021,3896,76,3426,470,1.95,87.94,1.0074993535040082
03-07-2021,3922,76,3426,496,1.94,87.35,1.0066735112936345
03-08-2021,3935,76,3434,501,1.93,87.27,1.003314635390107
03-09-2021,3984,77,3457,527,1.93,86.77,1.0124523506988563
03-10-2021,4030,77,3477,553,1.91,86.28,1.0115461847389557
03-11-2021,4062,77,3511,551,1.9,86.44,1.007940446650124
03-12-2021,4096,77,3550,546,1.88,86.67,1.0083702609551946
03-13-2021,4126,77,3594,532,1.87,87.11,1.00732421875
03-14-2021,4126,77,3594,532,1.87,87.11,1.0
03-15-2021,4126,77,3624,502,1.87,87.83,1.0
03-16-2021,4151,77,3691,460,1.85,88.92,1.0060591371788656
03-17-2021,4204,77,3729,475,1.83,88.7,1.0127680077089858
03-18-2021,4249,77,3758,491,1.81,88.44,1.0107040913415795
03-19-2021,4292,78,3786,506,1.82,88.21,1.0101200282419394
03-20-2021,4328,79,3805,523,1.83,87.92,1.0083876980428705
03-21-2021,4356,79,3805,551,1.81,87.35,1.0064695009242144
03-22-2021,4356,79,3819,537,1.81,87.67,1.0
03-23-2021,4388,79,3874,514,1.8,88.29,1.007346189164371
03-24-2021,4433,80,3914,519,1.8,88.29,1.0102552415679125
03-25-2021,4484,82,3914,570,1.83,87.29,1.0115046244078503
03-26-2021,4547,84,3947,600,1.85,86.8,1.014049955396967
03-27-2021,4603,84,4000,603,1.82,86.9,1.012315812623708
03-28-2021,4626,84,4000,626,1.82,86.47,1.0049967412557028
03-29-2021,4631,84,4029,602,1.81,87.0,1.0010808473843493
03-30-2021,4686,84,4089,597,1.79,87.26,1.01187648456057
03-31-2021,4732,84,4128,604,1.78,87.24,1.009816474605207
04-01-2021,4738,84,4128,610,1.77,87.13,1.0012679628064243
04-02-2021,4786,84,4170,616,1.76,87.13,1.0101308569016463
04-03-2021,4802,84,4170,632,1.75,86.84,1.0033430839949853
04-04-2021,4805,84,4170,635,1.75,86.78,1.000624739691795
04-05-2021,4864,85,4170,694,1.75,85.73,1.0122788761706556
04-06-2021,4864,85,4268,596,1.75,87.75,1.0
04-07-2021,4864,85,4347,517,1.75,89.37,1.0
04-08-2021,4904,85,4411,493,1.73,89.95,1.0082236842105263
04-09-2021,4932,85,4419,513,1.72,89.6,1.0057096247960848
04-10-2021,4944,85,4477,467,1.72,90.55,1.002433090024331
04-11-2021,4956,85,4477,479,1.72,90.33,1.0024271844660195
04-12-2021,4956,85,4510,446,1.72,91.0,1.0
04-13-2021,4962,86,4568,394,1.73,92.06,1.0012106537530265
04-14-2021,4985,86,4625,360,1.73,92.78,1.0046352277307538
04-15-2021,5004,86,4671,333,1.72,93.35,1.0038114343029088
04-16-2021,5010,86,4682,328,1.72,93.45,1.001199040767386
04-17-2021,5010,86,4724,286,1.72,94.29,1.0
04-18-2021,5010,86,4724,286,1.72,94.29,1.0
04-19-2021,5030,88,4746,284,1.75,94.35,1.003992015968064
04-20-2021,5040,88,4755,285,1.75,94.35,1.0019880715705765
04-21-2021,5044,88,4794,250,1.74,95.04,1.0007936507936508
04-22-2021,5046,88,4822,224,1.74,95.56,1.000396510705789
04-23-2021,5047,89,4839,208,1.76,95.88,1.000198176773682
04-24-2021,5047,89,4839,208,1.76,95.88,1.0
04-25-2021,5047,89,4839,208,1.76,95.88,1.0
04-26-2021,5055,90,4860,195,1.78,96.14,1.0015851000594413
04-27-2021,5058,90,4880,178,1.78,96.48,1.000593471810089
04-28-2021,5058,90,4897,161,1.78,96.82,1.0
04-29-2021,5060,90,4909,151,1.78,97.02,1.0003954132068011
04-30-2021,5060,90,4917,143,1.78,97.17,1.0
05-01-2021,5066,90,4917,149,1.78,97.06,1.0011857707509881
05-02-2021,5066,90,4917,149,1.78,97.06,1.0
05-03-2021,5067,90,4935,132,1.78,97.39,1.0001973943939992
05-04-2021,5071,90,4935,136,1.77,97.32,1.000789421748569
05-05-2021,5076,90,4935,141,1.77,97.22,1.0009859988168015
05-06-2021,5079,90,4935,144,1.77,97.16,1.0005910165484633
05-07-2021,5079,90,4935,144,1.77,97.16,1.0
05-08-2021,5079,90,4935,144,1.77,97.16,1.0
05-09-2021,5079,90,4935,144,1.77,97.16,1.0
05-10-2021,5083,90,4968,115,1.77,97.74,1.000787556605631
05-11-2021,5083,90,4968,115,1.77,97.74,1.0
05-12-2021,5086,90,4968,118,1.77,97.68,1.0005902026362385
05-13-2021,5087,90,4968,119,1.77,97.66,1.0001966181675186
05-14-2021,5087,90,4968,119,1.77,97.66,1.0
05-15-2021,5087,90,4968,119,1.77,97.66,1.0
05-16-2021,5087,90,4968,119,1.77,97.66,1.0
05-17-2021,5087,90,4974,113,1.77,97.78,1.0
05-18-2021,5089,90,4974,115,1.77,97.74,1.0003931590328288
05-19-2021,5089,90,4974,115,1.77,97.74,1.0
05-20-2021,5089,90,4974,115,1.77,97.74,1.0
05-21-2021,5089,90,4974,115,1.77,97.74,1.0
05-22-2021,5089,90,4974,115,1.77,97.74,1.0
05-23-2021,5089,90,4974,115,1.77,97.74,1.0
05-24-2021,5089,90,4995,94,1.77,98.15,1.0
05-25-2021,5089,90,4995,94,1.77,98.15,1.0
05-26-2021,5089,90,4995,94,1.77,98.15,1.0
05-27-2021,5090,90,4995,95,1.77,98.13,1.000196502259776
05-28-2021,5090,90,4995,95,1.77,98.13,1.0
05-29-2021,5090,90,4995,95,1.77,98.13,1.0
05-30-2021,5090,90,4995,95,1.77,98.13,1.0
05-31-2021,5090,90,4998,92,1.77,98.19,1.0
06-01-2021,5090,90,4998,92,1.77,98.19,1.0
06-02-2021,5090,90,4998,92,1.77,98.19,1.0
06-03-2021,5090,90,4998,92,1.77,98.19,1.0
06-04-2021,5090,90,4998,92,1.77,98.19,1.0
06-05-2021,5090,90,4998,92,1.77,98.19,1.0
06-06-2021,5090,90,4998,92,1.77,98.19,1.0
06-07-2021,5090,90,4998,92,1.77,98.19,1.0
06-08-2021,5090,90,4998,92,1.77,98.19,1.0
06-09-2021,5090,90,4998,92,1.77,98.19,1.0
06-10-2021,5090,90,4998,92,1.77,98.19,1.0
06-11-2021,5090,90,4998,92,1.77,98.19,1.0
06-12-2021,5090,90,4998,92,1.77,98.19,1.0
06-13-2021,5090,90,4998,92,1.77,98.19,1.0
06-14-2021,5090,90,4999,91,1.77,98.21,1.0
06-15-2021,5091,90,4999,92,1.77,98.19,1.000196463654224
06-16-2021,5091,90,4999,92,1.77,98.19,1.0
06-17-2021,5091,90,4999,92,1.77,98.19,1.0
06-18-2021,5091,90,4999,92,1.77,98.19,1.0
06-19-2021,5091,90,4999,92,1.77,98.19,1.0
06-20-2021,5091,90,4999,92,1.77,98.19,1.0
06-21-2021,5091,90,4999,92,1.77,98.19,1.0
06-22-2021,5091,90,4999,92,1.77,98.19,1.0
06-23-2021,5091,90,5000,91,1.77,98.21,1.0
06-24-2021,5091,90,5000,91,1.77,98.21,1.0
06-25-2021,5091,90,5000,91,1.77,98.21,1.0
06-26-2021,5091,90,5000,91,1.77,98.21,1.0
06-27-2021,5091,90,5000,91,1.77,98.21,1.0
06-28-2021,5092,90,5000,92,1.77,98.19,1.0001964250638382
06-29-2021,5092,90,5000,92,1.77,98.19,1.0
06-30-2021,5092,90,5000,92,1.77,98.19,1.0
07-01-2021,5092,90,5000,92,1.77,98.19,1.0
07-02-2021,5092,90,5000,92,1.77,98.19,1.0
07-03-2021,5092,90,5000,92,1.77,98.19,1.0
07-04-2021,5092,90,5000,92,1.77,98.19,1.0
07-05-2021,5092,90,5002,90,1.77,98.23,1.0
07-06-2021,5092,90,5002,90,1.77,98.23,1.0
07-07-2021,5092,90,5002,90,1.77,98.23,1.0
07-08-2021,5092,90,5002,90,1.77,98.23,1.0
07-09-2021,5092,90,5002,90,1.77,98.23,1.0
07-10-2021,5092,90,5002,90,1.77,98.23,1.0
07-11-2021,5092,90,5002,90,1.77,98.23,1.0
07-12-2021,5092,90,5002,90,1.77,98.23,1.0
07-13-2021,5092,90,5002,90,1.77,98.23,1.0
07-14-2021,5094,90,5002,92,1.77,98.19,1.000392772977219
07-15-2021,5094,90,5002,92,1.77,98.19,1.0
07-16-2021,5094,90,5002,92,1.77,98.19,1.0
07-17-2021,5094,90,5002,92,1.77,98.19,1.0
07-18-2021,5094,90,5002,92,1.77,98.19,1.0
07-19-2021,5096,90,5002,94,1.77,98.16,1.000392618767177
07-20-2021,5102,90,5002,100,1.76,98.04,1.001177394034537
07-21-2021,5102,90,5002,100,1.76,98.04,1.0
07-22-2021,5107,90,5002,105,1.76,97.94,1.0009800078400628
07-23-2021,5107,90,5002,105,1.76,97.94,1.0
07-24-2021,5107,90,5002,105,1.76,97.94,1.0
07-25-2021,5108,90,5002,106,1.76,97.92,1.000195809672998
07-26-2021,5116,90,5005,111,1.76,97.83,1.0015661707126078
07-27-2021,5131,90,5005,126,1.75,97.54,1.0029319781078967
07-28-2021,5133,90,5005,128,1.75,97.51,1.0003897875657766
07-29-2021,5133,90,5005,128,1.75,97.51,1.0
07-30-2021,5143,90,5005,138,1.75,97.32,1.0019481784531463
07-31-2021,5143,90,5005,138,1.75,97.32,1.0
08-01-2021,5143,90,5005,138,1.75,97.32,1.0
08-02-2021,5147,90,5009,138,1.75,97.32,1.0007777561734397
08-03-2021,5167,90,5009,158,1.74,96.94,1.003885758694385
08-04-2021,5178,90,5009,169,1.74,96.74,1.0021288949100058
08-05-2021,5179,90,0,5179,1.74,0,1.000193124758594
08-06-2021,5183,90,0,5183,1.74,0,1.0007723498744932
08-07-2021,5183,90,0,5183,1.74,0,1.0
08-08-2021,5183,90,0,5183,1.74,0,1.0
08-09-2021,5194,90,0,5194,1.73,0,1.0021223229789697
08-10-2021,5207,90,0,5207,1.73,0,1.0025028879476319
08-11-2021,5210,90,0,5210,1.73,0,1.0005761474937584
08-12-2021,5217,90,0,5217,1.73,0,1.0013435700575817
08-13-2021,5222,90,0,5222,1.72,0,1.0009584052137244
08-14-2021,5222,90,0,5222,1.72,0,1.0
08-15-2021,5222,90,0,5222,1.72,0,1.0
08-16-2021,5231,90,0,5231,1.72,0,1.0017234775947912
08-17-2021,5238,90,0,5238,1.72,0,1.0013381762569298
08-18-2021,5244,90,0,5244,1.72,0,1.0011454753722795
08-19-2021,5250,90,0,5250,1.71,0,1.0011441647597255
08-20-2021,5255,90,0,5255,1.71,0,1.000952380952381
08-21-2021,5255,90,0,5255,1.71,0,1.0
08-22-2021,5255,90,0,5255,1.71,0,1.0
08-23-2021,5261,90,0,5261,1.71,0,1.0011417697431018
08-24-2021,5279,90,0,5279,1.7,0,1.0034214027751378
08-25-2021,5292,90,0,5292,1.7,0,1.00246258761129
08-26-2021,5305,90,0,5305,1.7,0,1.002456538170824
08-27-2021,5314,90,0,5314,1.69,0,1.0016965127238455
08-28-2021,5314,90,0,5314,1.69,0,1.0
08-29-2021,5314,90,0,5314,1.69,0,1.0
08-30-2021,5321,90,0,5321,1.69,0,1.0013172751223185
08-31-2021,5331,90,0,5331,1.69,0,1.0018793459875963
09-01-2021,5331,90,0,5331,1.69,0,1.0
09-02-2021,5345,90,0,5345,1.68,0,1.0026261489401613
09-03-2021,5345,90,0,5345,1.68,0,1.0
09-04-2021,5345,90,0,5345,1.68,0,1.0
09-05-2021,5345,90,0,5345,1.68,0,1.0
09-06-2021,5345,90,0,5345,1.68,0,1.0
09-07-2021,5351,90,0,5351,1.68,0,1.0011225444340506
09-08-2021,5358,90,0,5358,1.68,0,1.0013081666978134
09-09-2021,5366,90,0,5366,1.68,0,1.0014930944382232
09-10-2021,5373,90,0,5373,1.68,0,1.0013045098770033
09-11-2021,5373,90,0,5373,1.68,0,1.0
09-12-2021,5373,90,0,5373,1.68,0,1.0
09-13-2021,5388,90,0,5388,1.67,0,1.0027917364600782
09-14-2021,5399,90,0,5399,1.67,0,1.0020415738678545
09-15-2021,5402,90,0,5402,1.67,0,1.0005556584552695
09-16-2021,5408,90,0,5408,1.66,0,1.0011106997408368
09-17-2021,5412,90,0,5412,1.66,0,1.0007396449704142
09-18-2021,5412,90,0,5412,1.66,0,1.0
09-19-2021,5412,90,0,5412,1.66,0,1.0
09-20-2021,5419,90,0,5419,1.66,0,1.0012934220251293
09-21-2021,5423,90,0,5423,1.66,0,1.0007381435689242
09-22-2021,5423,90,0,5423,1.66,0,1.0
09-23-2021,5426,90,0,5426,1.66,0,1.0005531993361607
09-24-2021,5427,90,0,5427,1.66,0,1.0001842978252857
09-25-2021,5427,90,0,5427,1.66,0,1.0
09-26-2021,5427,90,0,5427,1.66,0,1.0
09-27-2021,5428,91,0,5428,1.68,0,1.000184263865856
09-28-2021,5436,91,0,5436,1.67,0,1.0014738393515106
09-29-2021,5438,91,0,5438,1.67,0,1.0003679175864606
09-30-2021,5440,91,0,5440,1.67,0,1.0003677822728945
10-01-2021,5440,91,0,5440,1.67,0,1.0
10-02-2021,5440,91,0,5440,1.67,0,1.0
10-03-2021,5440,91,0,5440,1.67,0,1.0
10-04-2021,5444,91,0,5444,1.67,0,1.000735294117647
10-05-2021,5456,91,0,5456,1.67,0,1.0022042615723732
10-06-2021,5460,91,0,5460,1.67,0,1.000733137829912
10-07-2021,5464,91,0,5464,1.67,0,1.0007326007326007
10-08-2021,5466,91,0,5466,1.66,0,1.0003660322108345
10-09-2021,5466,91,0,5466,1.66,0,1.0
10-10-2021,5466,91,0,5466,1.66,0,1.0
10-11-2021,5470,91,0,5470,1.66,0,1.0007317965605562
10-12-2021,5470,91,0,5470,1.66,0,1.0
10-13-2021,5470,91,0,5470,1.66,0,1.0
10-14-2021,5470,91,0,5470,1.66,0,1.0
10-15-2021,5473,91,0,5473,1.66,0,1.0005484460694698
10-16-2021,5473,91,0,5473,1.66,0,1.0
10-17-2021,5473,91,0,5473,1.66,0,1.0
10-18-2021,5475,91,0,5475,1.66,0,1.0003654302941714
10-19-2021,5479,91,0,5479,1.66,0,1.0007305936073059
10-20-2021,5481,91,0,5481,1.66,0,1.0003650301149845
10-21-2021,5490,91,0,5490,1.66,0,1.0016420361247949
10-22-2021,5497,91,0,5497,1.66,0,1.0012750455373407
10-23-2021,5497,91,0,5497,1.66,0,1.0
10-24-2021,5497,91,0,5497,1.66,0,1.0
10-25-2021,5509,92,0,5509,1.67,0,1.002183008913953
10-26-2021,5521,92,0,5521,1.67,0,1.0021782537665638
10-27-2021,5534,92,0,5534,1.66,0,1.0023546458974824
10-28-2021,5540,92,0,5540,1.66,0,1.0010842067220818
10-29-2021,5547,92,0,5547,1.66,0,1.0012635379061372
10-30-2021,5547,92,0,5547,1.66,0,1.0
10-31-2021,5547,92,0,5547,1.66,0,1.0
11-01-2021,5547,92,0,5547,1.66,0,1.0
11-02-2021,5547,92,0,5547,1.66,0,1.0
11-03-2021,5569,92,0,5569,1.65,0,1.0039661078060214
11-04-2021,5582,92,0,5582,1.65,0,1.0023343508708924
11-05-2021,5588,92,0,5588,1.65,0,1.0010748835542815
11-06-2021,5588,92,0,5588,1.65,0,1.0
11-07-2021,5588,92,0,5588,1.65,0,1.0
11-08-2021,5598,92,0,5598,1.64,0,1.0017895490336435
11-09-2021,5610,92,0,5610,1.64,0,1.0021436227224008
11-10-2021,5610,92,0,5610,1.64,0,1.0
11-11-2021,5614,92,0,5614,1.64,0,1.0007130124777184
11-12-2021,5624,92,0,5624,1.64,0,1.001781261132882
11-13-2021,5624,92,0,5624,1.64,0,1.0
11-14-2021,5624,92,0,5624,1.64,0,1.0
11-15-2021,5654,92,0,5654,1.63,0,1.0053342816500712
11-16-2021,5683,92,0,5683,1.62,0,1.0051291121330033
11-17-2021,5711,92,0,5711,1.61,0,1.0049269751891607
11-18-2021,5734,92,0,5734,1.6,0,1.0040273157065314
11-19-2021,5758,93,0,5758,1.62,0,1.0041855598186258
11-20-2021,5758,93,0,5758,1.62,0,1.0
11-21-2021,5758,93,0,5758,1.62,0,1.0
11-22-2021,5790,93,0,5790,1.61,0,1.0055574852379299
11-23-2021,5833,93,0,5833,1.59,0,1.007426597582038
11-24-2021,5872,93,0,5872,1.58,0,1.0066860963483628
11-25-2021,5908,93,0,5908,1.57,0,1.0061307901907357
11-26-2021,5930,93,0,5930,1.57,0,1.0037237643872714
11-27-2021,5930,93,0,5930,1.57,0,1.0
11-28-2021,5930,93,0,5930,1.57,0,1.0
11-29-2021,5979,93,0,5979,1.56,0,1.0082630691399663
11-30-2021,6039,93,0,6039,1.54,0,1.010035122930256
12-01-2021,6084,93,0,6084,1.53,0,1.007451564828614
12-02-2021,6118,93,0,6118,1.52,0,1.0055884286653518
12-03-2021,6148,93,0,6148,1.51,0,1.004903563255966
12-04-2021,6148,93,0,6148,1.51,0,1.0
12-05-2021,6148,93,0,6148,1.51,0,1.0
12-06-2021,6217,94,0,6217,1.51,0,1.0112231620039036
12-07-2021,6308,94,0,6308,1.49,0,1.0146372848640823
12-08-2021,6308,94,0,6308,1.49,0,1.0
12-09-2021,6357,94,0,6357,1.48,0,1.0077679137603044
12-10-2021,6464,94,0,6464,1.45,0,1.0168318389177284
12-11-2021,6464,94,0,6464,1.45,0,1.0
12-12-2021,6464,94,0,6464,1.45,0,1.0
12-13-2021,6464,94,0,6464,1.45,0,1.0
12-14-2021,6719,94,0,6719,1.4,0,1.0394492574257426
12-15-2021,6807,94,0,6807,1.38,0,1.013097187081411
12-16-2021,6915,94,0,6915,1.36,0,1.0158660202732481
12-17-2021,7007,95,0,7007,1.36,0,1.0133044107013738
12-18-2021,7007,95,0,7007,1.36,0,1.0
12-19-2021,7007,95,0,7007,1.36,0,1.0
12-20-2021,7160,96,0,7160,1.34,0,1.0218353075495932
12-21-2021,7160,96,0,7160,1.34,0,1.0
12-22-2021,7351,97,0,7351,1.32,0,1.0266759776536314
12-23-2021,7447,97,0,7447,1.3,0,1.0130594476941912
12-24-2021,7526,98,0,7526,1.3,0,1.0106082986437492
12-25-2021,7526,98,0,7526,1.3,0,1.0
12-26-2021,7526,98,0,7526,1.3,0,1.0
12-27-2021,7656,98,0,7656,1.28,0,1.0172734520329525
12-28-2021,7657,98,0,7657,1.28,0,1.0001306165099269
12-29-2021,7808,99,0,7808,1.27,0,1.019720517173828
12-30-2021,7808,99,0,7808,1.27,0,1.0
12-31-2021,8202,100,0,8202,1.22,0,1.0504610655737705
01-01-2022,8202,100,0,8202,1.22,0,1.0
01-02-2022,8202,100,0,8202,1.22,0,1.0
01-03-2022,8487,102,0,8487,1.2,0,1.0347476225310899
01-04-2022,8682,102,0,8682,1.17,0,1.022976316719689
01-05-2022,8847,103,0,8847,1.16,0,1.0190048375950242
01-06-2022,8847,103,0,8847,1.16,0,1.0
01-07-2022,9095,103,0,9095,1.13,0,1.028032101277269
01-08-2022,9095,103,0,9095,1.13,0,1.0
01-09-2022,9095,103,0,9095,1.13,0,1.0
01-10-2022,9518,103,0,9518,1.08,0,1.0465090709180869
01-11-2022,9518,103,0,9518,1.08,0,1.0
01-12-2022,10009,103,0,10009,1.03,0,1.0515864677453246
01-13-2022,10189,103,0,10189,1.01,0,1.0179838145668898
01-14-2022,10350,103,0,10350,1.0,0,1.0158013544018059
01-15-2022,10350,103,0,10350,1.0,0,1.0
01-16-2022,10350,103,0,10350,1.0,0,1.0
01-17-2022,10641,103,0,10641,0.97,0,1.0281159420289856
01-18-2022,10856,103,0,10856,0.95,0,1.0202048679635372
01-19-2022,11077,105,0,11077,0.95,0,1.0203574060427414
01-20-2022,11278,106,0,11278,0.94,0,1.018145707321477
01-21-2022,11466,107,0,11466,0.93,0,1.0166696222734528
01-22-2022,11466,107,0,11466,0.93,0,1.0
01-23-2022,11466,107,0,11466,0.93,0,1.0
01-24-2022,11786,108,0,11786,0.92,0,1.0279085993371708
01-25-2022,11786,108,0,11786,0.92,0,1.0
01-26-2022,11995,109,0,11995,0.91,0,1.017732903444765
01-27-2022,12229,109,0,12229,0.89,0,1.019508128386828
01-28-2022,12462,109,0,12462,0.87,0,1.0190530705699568
01-29-2022,12462,109,0,12462,0.87,0,1.0
01-30-2022,12462,109,0,12462,0.87,0,1.0
01-31-2022,12884,109,0,12884,0.85,0,1.0338629433477773
02-01-2022,12884,109,0,12884,0.85,0,1.0
02-02-2022,13085,109,0,13085,0.83,0,1.0156007451102143
02-03-2022,13328,109,0,13328,0.82,0,1.0185708826901032
02-04-2022,13328,109,0,13328,0.82,0,1.0
02-05-2022,13328,109,0,13328,0.82,0,1.0
02-06-2022,13328,109,0,13328,0.82,0,1.0
02-07-2022,13571,109,0,13571,0.8,0,1.0182322929171668
02-08-2022,13572,109,0,13572,0.8,0,1.0000736865374695
02-09-2022,13788,109,0,13788,0.79,0,1.0159151193633953
02-10-2022,13852,110,0,13852,0.79,0,1.0046417174354512
02-11-2022,13861,110,0,13861,0.79,0,1.000649725671383
02-12-2022,13861,110,0,13861,0.79,0,1.0
02-13-2022,13861,110,0,13861,0.79,0,1.0
02-14-2022,13988,110,0,13988,0.79,0,1.0091623980953754
02-15-2022,14044,110,0,14044,0.78,0,1.004003431512725
02-16-2022,14086,110,0,14086,0.78,0,1.002990600968385
02-17-2022,14086,110,0,14086,0.78,0,1.0
02-18-2022,14147,112,0,14147,0.79,0,1.004330540962658
02-19-2022,14147,112,0,14147,0.79,0,1.0
02-20-2022,14147,112,0,14147,0.79,0,1.0
02-21-2022,14207,112,0,14207,0.79,0,1.0042411818760162
02-22-2022,14207,112,0,14207,0.79,0,1.0
02-23-2022,14262,112,0,14262,0.79,0,1.0038713310339973
02-24-2022,14291,112,0,14291,0.78,0,1.0020333754031692
02-25-2022,14310,112,0,14310,0.78,0,1.0013295080820097
02-26-2022,14310,112,0,14310,0.78,0,1.0
02-27-2022,14310,112,0,14310,0.78,0,1.0
02-28-2022,14369,112,0,14369,0.78,0,1.0041229909154437
03-01-2022,14414,112,0,14414,0.78,0,1.0031317419444639
03-02-2022,14435,112,0,14435,0.78,0,1.0014569168863605
03-03-2022,14466,112,0,14466,0.77,0,1.0021475580187045
03-04-2022,14487,112,0,14487,0.77,0,1.0014516798009125
03-05-2022,14487,112,0,14487,0.77,0,1.0
03-06-2022,14487,112,0,14487,0.77,0,1.0
03-07-2022,14523,112,0,14523,0.77,0,1.0024849865396563
03-08-2022,14581,112,0,14581,0.77,0,1.0039936652206845
03-09-2022,14629,112,0,14629,0.77,0,1.003291955284274
03-10-2022,14653,112,0,14653,0.76,0,1.0016405769362227
03-11-2022,14691,112,0,14691,0.76,0,1.0025933255988535
03-12-2022,14691,112,0,14691,0.76,0,1.0
03-13-2022,14691,112,0,14691,0.76,0,1.0
03-14-2022,14726,112,0,14726,0.76,0,1.002382410999932
03-15-2022,14789,112,0,14789,0.76,0,1.004278147494228
03-16-2022,14834,112,0,14834,0.76,0,1.003042802082629
03-17-2022,14834,112,0,14834,0.76,0,1.0
03-18-2022,14870,112,0,14870,0.75,0,1.0024268572199002
03-19-2022,14870,112,0,14870,0.75,0,1.0
03-20-2022,14870,112,0,14870,0.75,0,1.0
03-21-2022,14968,112,0,14968,0.75,0,1.0065904505716208
03-22-2022,15034,112,0,15034,0.74,0,1.0044094067343667
03-23-2022,15079,112,0,15079,0.74,0,1.0029932153784755
03-24-2022,15125,112,0,15125,0.74,0,1.0030506001724253
03-25-2022,15125,112,0,15125,0.74,0,1.0
03-26-2022,15125,112,0,15125,0.74,0,1.0
03-27-2022,15125,112,0,15125,0.74,0,1.0
03-28-2022,15181,113,0,15181,0.74,0,1.003702479338843
03-29-2022,15272,113,0,15272,0.74,0,1.0059943350240432
03-30-2022,15307,113,0,15307,0.74,0,1.0022917757988477
03-31-2022,15345,113,0,15345,0.74,0,1.0024825243352715
04-01-2022,15345,113,0,15345,0.74,0,1.0
04-02-2022,15345,113,0,15345,0.74,0,1.0
04-03-2022,15345,113,0,15345,0.74,0,1.0
04-04-2022,15345,113,0,15345,0.74,0,1.0
04-05-2022,15345,113,0,15345,0.74,0,1.0
04-06-2022,15538,114,0,15538,0.73,0,1.0125773867709351
04-07-2022,15581,114,0,15581,0.73,0,1.0027674089329386
04-08-2022,15629,114,0,15629,0.73,0,1.0030806751813106
04-09-2022,15629,114,0,15629,0.73,0,1.0
04-10-2022,15629,114,0,15629,0.73,0,1.0
04-11-2022,15683,114,0,15683,0.73,0,1.0034551154904345
04-12-2022,15779,114,0,15779,0.72,0,1.0061212778167443
04-13-2022,15827,114,0,15827,0.72,0,1.003042017871855
04-14-2022,15874,114,0,15874,0.72,0,1.0029696088961901
04-15-2022,15874,114,0,15874,0.72,0,1.0
04-16-2022,15874,114,0,15874,0.72,0,1.0
04-17-2022,15874,114,0,15874,0.72,0,1.0
04-18-2022,15874,114,0,15874,0.72,0,1.0
04-19-2022,15981,114,0,15981,0.71,0,1.0067405820839108
04-20-2022,16076,114,0,16076,0.71,0,1.0059445591640073
04-21-2022,16140,114,0,16140,0.71,0,1.0039810898233392
04-22-2022,16186,114,0,16186,0.7,0,1.0028500619578686
04-23-2022,16186,114,0,16186,0.7,0,1.0
04-24-2022,16186,114,0,16186,0.7,0,1.0
04-25-2022,16186,114,0,16186,0.7,0,1.0
04-26-2022,16186,114,0,16186,0.7,0,1.0
04-27-2022,16186,114,0,16186,0.7,0,1.0
04-28-2022,16186,114,0,16186,0.7,0,1.0
04-29-2022,16437,115,0,16437,0.7,0,1.0155072284690474
04-30-2022,16437,115,0,16437,0.7,0,1.0
05-01-2022,16437,115,0,16437,0.7,0,1.0
05-02-2022,16476,115,0,16476,0.7,0,1.002372695747399
05-03-2022,16524,115,0,16524,0.7,0,1.0029133284777858
05-04-2022,16561,115,0,16561,0.69,0,1.002239167271847
05-05-2022,16561,115,0,16561,0.69,0,1.0
05-06-2022,16624,115,0,16624,0.69,0,1.0038041181088098
05-07-2022,16624,115,0,16624,0.69,0,1.0
05-08-2022,16624,115,0,16624,0.69,0,1.0
05-09-2022,16666,115,0,16666,0.69,0,1.002526467757459
05-10-2022,16743,115,0,16743,0.69,0,1.0046201848073923
05-11-2022,16785,115,0,16785,0.69,0,1.0025085110195306
05-12-2022,16823,115,0,16823,0.68,0,1.0022639261245159
05-13-2022,16852,115,0,16852,0.68,0,1.0017238304701896
05-14-2022,16852,115,0,16852,0.68,0,1.0
05-15-2022,16852,115,0,16852,0.68,0,1.0
05-16-2022,16852,115,0,16852,0.68,0,1.0
05-17-2022,16852,115,0,16852,0.68,0,1.0
05-18-2022,16852,115,0,16852,0.68,0,1.0
05-19-2022,16852,115,0,16852,0.68,0,1.0
05-20-2022,16991,115,0,16991,0.68,0,1.0082482791360077
05-21-2022,16991,115,0,16991,0.68,0,1.0
05-22-2022,17059,115,0,17059,0.67,0,1.00400211876876
05-23-2022,17023,115,0,17023,0.68,0,1.0021103229966586
05-24-2022,17045,115,0,17045,0.67,0,1.0012923691476239
05-25-2022,17059,115,0,17059,0.67,0,1.0008213552361396
05-26-2022,17059,115,0,17059,0.67,0,1.0
05-27-2022,17083,115,0,17083,0.67,0,1.0014068819977724
05-28-2022,17083,115,0,17083,0.67,0,1.0
05-29-2022,17083,115,0,17083,0.67,0,1.0
05-30-2022,17105,115,0,17105,0.67,0,1.0012878300064392
05-31-2022,17124,115,0,17124,0.67,0,1.0011107863197894
06-01-2022,17124,115,0,17124,0.67,0,1.0
06-02-2022,17124,115,0,17124,0.67,0,1.0
06-03-2022,17124,115,0,17124,0.67,0,1.0
06-04-2022,17124,115,0,17124,0.67,0,1.0
06-05-2022,17124,115,0,17124,0.67,0,1.0
06-06-2022,17124,115,0,17124,0.67,0,1.0
06-07-2022,17124,115,0,17124,0.67,0,1.0
06-08-2022,17124,115,0,17124,0.67,0,1.0
06-09-2022,17124,115,0,17124,0.67,0,1.0
06-10-2022,17124,115,0,17124,0.67,0,1.0
06-11-2022,17124,115,0,17124,0.67,0,1.0
06-12-2022,17124,115,0,17124,0.67,0,1.0
06-13-2022,17124,115,0,17124,0.67,0,1.0
06-14-2022,17124,115,0,17124,0.67,0,1.0
06-15-2022,17376,115,0,17376,0.66,0,1.0147161878065873
06-16-2022,17376,115,0,17376,0.66,0,1.0
06-17-2022,17413,115,0,17413,0.66,0,1.0021293738489871
06-18-2022,17413,115,0,17413,0.66,0,1.0
06-19-2022,17413,115,0,17413,0.66,0,1.0
06-20-2022,17502,115,0,17502,0.66,0,1.0051111238729684
06-21-2022,17570,115,0,17570,0.65,0,1.003885270254828
06-22-2022,17631,115,0,17631,0.65,0,1.0034718269778031
06-23-2022,17631,115,0,17631,0.65,0,1.0
06-24-2022,17719,115,0,17719,0.65,0,1.0049912086665533
06-25-2022,17719,115,0,17719,0.65,0,1.0
06-26-2022,17719,115,0,17719,0.65,0,1.0
06-27-2022,17767,115,0,17767,0.65,0,1.0027089564873863
06-28-2022,17767,115,0,17767,0.65,0,1.0
06-29-2022,17961,115,0,17961,0.64,0,1.010919119716328
06-30-2022,18016,115,0,18016,0.64,0,1.0030621903012082
07-01-2022,18092,115,0,18092,0.64,0,1.0042184724689165
07-02-2022,18092,115,0,18092,0.64,0,1.0
07-03-2022,18092,115,0,18092,0.64,0,1.0
07-04-2022,18236,115,0,18236,0.63,0,1.007959319036038
07-05-2022,18361,115,0,18361,0.63,0,1.0068545733713534
07-06-2022,18361,115,0,18361,0.63,0,1.0
07-07-2022,18361,115,0,18361,0.63,0,1.0
07-08-2022,18361,115,0,18361,0.63,0,1.0
07-09-2022,18710,115,0,18710,0.61,0,1.0190076793202985
07-10-2022,18710,115,0,18710,0.61,0,1.0
07-11-2022,18734,116,0,18734,0.62,0,1.001282736504543
07-12-2022,18886,116,0,18886,0.61,0,1.0081135902636917
07-13-2022,18977,116,0,18977,0.61,0,1.0048183839881393
07-14-2022,18977,116,0,18977,0.61,0,1.0
07-15-2022,19132,116,0,19132,0.61,0,1.0081677820519577
07-16-2022,19200,116,0,19200,0.6,0,1.003554254651892
07-17-2022,19200,116,0,19200,0.6,0,1.0
07-18-2022,19253,117,0,19253,0.61,0,1.0027604166666666
07-19-2022,19353,117,0,19353,0.6,0,1.0051939957409235
07-20-2022,19421,117,0,19421,0.6,0,1.0035136671317109
07-21-2022,19474,117,0,19474,0.6,0,1.0027290046856496
07-22-2022,19532,117,0,19532,0.6,0,1.002978330081134
07-23-2022,19532,117,0,19532,0.6,0,1.0
07-24-2022,19532,117,0,19532,0.6,0,1.0
07-25-2022,19619,118,0,19619,0.6,0,1.004454228957608
07-26-2022,19701,118,0,19701,0.6,0,1.0041796217951986
07-27-2022,19752,118,0,19752,0.6,0,1.0025887010811634
07-28-2022,19752,118,0,19752,0.6,0,1.0
07-29-2022,19793,118,0,19793,0.6,0,1.002075739165654
07-30-2022,19793,118,0,19793,0.6,0,1.0
07-31-2022,19793,118,0,19793,0.6,0,1.0
08-01-2022,19890,118,0,19890,0.59,0,1.0049007224776436
08-02-2022,19942,118,0,19942,0.59,0,1.0026143790849673
08-03-2022,19965,118,0,19965,0.59,0,1.001153344699629
08-04-2022,19983,118,0,19983,0.59,0,1.000901577761082
08-05-2022,20007,118,0,20007,0.59,0,1.0012010208677375
08-06-2022,20007,118,0,20007,0.59,0,1.0
08-07-2022,20007,118,0,20007,0.59,0,1.0
08-08-2022,20042,118,0,20042,0.59,0,1.0017493877143
08-09-2022,20074,118,0,20074,0.59,0,1.0015966470412134
08-10-2022,20094,118,0,20094,0.59,0,1.0009963136395337
08-11-2022,20113,118,0,20113,0.59,0,1.0009455558873295
08-12-2022,20130,118,0,20130,0.59,0,1.0008452244816786
08-13-2022,20130,118,0,20130,0.59,0,1.0
08-14-2022,20130,118,0,20130,0.59,0,1.0
08-15-2022,20130,118,0,20130,0.59,0,1.0
08-16-2022,20160,118,0,20160,0.59,0,1.0014903129657229
08-17-2022,20196,118,0,20196,0.58,0,1.0017857142857143
08-18-2022,20215,118,0,20215,0.58,0,1.000940780352545
08-19-2022,20224,118,0,20224,0.58,0,1.000445213950037
08-20-2022,20224,118,0,20224,0.58,0,1.0
08-21-2022,20224,118,0,20224,0.58,0,1.0
08-22-2022,20242,118,0,20242,0.58,0,1.0008900316455696
08-23-2022,20280,118,0,20280,0.58,0,1.0018772848532753
08-24-2022,20292,118,0,20292,0.58,0,1.0005917159763313
08-25-2022,20310,118,0,20310,0.58,0,1.0008870490833826
08-26-2022,20323,118,0,20323,0.58,0,1.0006400787789267
08-27-2022,20323,118,0,20323,0.58,0,1.0
08-28-2022,20323,118,0,20323,0.58,0,1.0
08-29-2022,20341,118,0,20341,0.58,0,1.0008856960094474
08-30-2022,20365,118,0,20365,0.58,0,1.0011798829949363
08-31-2022,20373,118,0,20373,0.58,0,1.0003928308372207
09-01-2022,20385,118,0,20385,0.58,0,1.0005890148726255
09-02-2022,20398,118,0,20398,0.58,0,1.0006377238165318
09-03-2022,20398,118,0,20398,0.58,0,1.0
09-04-2022,20398,118,0,20398,0.58,0,1.0
09-05-2022,20412,118,0,20412,0.58,0,1.0006863417982155
09-06-2022,20438,118,0,20438,0.58,0,1.0012737605330198
09-07-2022,20456,118,0,20456,0.58,0,1.0008807123984735
09-08-2022,20456,118,0,20456,0.58,0,1.0
09-09-2022,20486,118,0,20486,0.58,0,1.0014665623777865
09-10-2022,20486,118,0,20486,0.58,0,1.0
09-11-2022,20486,118,0,20486,0.58,0,1.0
09-12-2022,20500,118,0,20500,0.58,0,1.0006833935370496
09-13-2022,20533,118,0,20533,0.57,0,1.001609756097561
09-14-2022,20540,118,0,20540,0.57,0,1.0003409146252373
09-15-2022,20552,118,0,20552,0.57,0,1.0005842259006816
09-16-2022,20552,118,0,20552,0.57,0,1.0
09-17-2022,20552,118,0,20552,0.57,0,1.0
09-18-2022,20552,118,0,20552,0.57,0,1.0
09-19-2022,20567,118,0,20567,0.57,0,1.0007298559750877
09-20-2022,20593,118,0,20593,0.57,0,1.001264161034667
09-21-2022,20607,118,0,20607,0.57,0,1.0006798426649832
09-22-2022,20628,118,0,20628,0.57,0,1.0010190711894016
09-23-2022,20646,118,0,20646,0.57,0,1.0008726003490402
09-24-2022,20646,118,0,20646,0.57,0,1.0
09-25-2022,20646,118,0,20646,0.57,0,1.0
09-26-2022,20671,118,0,20671,0.57,0,1.0012108883076625
09-27-2022,20729,118,0,20729,0.57,0,1.0028058632867303
09-28-2022,20753,118,0,20753,0.57,0,1.0011577982536544
09-29-2022,20763,118,0,20763,0.57,0,1.00048185804462
09-30-2022,20793,118,0,20793,0.57,0,1.0014448779078169
10-01-2022,20793,118,0,20793,0.57,0,1.0
10-02-2022,20793,118,0,20793,0.57,0,1.0
10-03-2022,20828,118,0,20828,0.57,0,1.0016832587890154
10-04-2022,20892,118,0,20892,0.56,0,1.0030727866333782
10-05-2022,20920,118,0,20920,0.56,0,1.0013402259237987
10-06-2022,20957,118,0,20957,0.56,0,1.0017686424474188
10-07-2022,21002,118,0,21002,0.56,0,1.0021472539008447
10-08-2022,21002,118,0,21002,0.56,0,1.0
10-09-2022,21002,118,0,21002,0.56,0,1.0
10-10-2022,21053,118,0,21053,0.56,0,1.0024283401580802
10-11-2022,21134,118,0,21134,0.56,0,1.0038474326699283
10-12-2022,21178,118,0,21178,0.56,0,1.0020819532506862
10-13-2022,21201,118,0,21201,0.56,0,1.0010860326754178
10-14-2022,21245,118,0,21245,0.56,0,1.0020753738031225
10-15-2022,21245,118,0,21245,0.56,0,1.0
10-16-2022,21245,118,0,21245,0.56,0,1.0
10-17-2022,21291,118,0,21291,0.55,0,1.002165215344787
10-18-2022,21363,118,0,21363,0.55,0,1.003381710581936
10-19-2022,21400,118,0,21400,0.55,0,1.001731966484108
10-20-2022,21400,118,0,21400,0.55,0,1.0
10-21-2022,21452,119,0,21452,0.55,0,1.002429906542056
10-22-2022,21452,119,0,21452,0.55,0,1.0
10-23-2022,21452,119,0,21452,0.55,0,1.0
10-24-2022,21473,119,0,21473,0.55,0,1.000978929703524
10-25-2022,21526,119,0,21526,0.55,0,1.002468215899036
10-26-2022,21544,119,0,21544,0.55,0,1.0008361980860354
10-27-2022,21565,119,0,21565,0.55,0,1.000974749350167
10-28-2022,21584,119,0,21584,0.55,0,1.0008810572687226
10-29-2022,21584,119,0,21584,0.55,0,1.0
10-30-2022,21584,119,0,21584,0.55,0,1.0
10-31-2022,21604,119,0,21604,0.55,0,1.0009266123054115
11-01-2022,21604,119,0,21604,0.55,0,1.0
11-02-2022,21604,119,0,21604,0.55,0,1.0
11-03-2022,21627,119,0,21627,0.55,0,1.0010646176633957
11-04-2022,21662,119,0,21662,0.55,0,1.0016183474360754
11-05-2022,21662,119,0,21662,0.55,0,1.0
11-06-2022,21662,119,0,21662,0.55,0,1.0
11-07-2022,21681,119,0,21681,0.55,0,1.0008771119933524
11-08-2022,21723,119,0,21723,0.55,0,1.0019371800193717
11-09-2022,21739,119,0,21739,0.55,0,1.000736546517516
11-10-2022,21739,119,0,21739,0.55,0,1.0
11-11-2022,21739,119,0,21739,0.55,0,1.0
11-12-2022,21739,119,0,21739,0.55,0,1.0
11-13-2022,21739,119,0,21739,0.55,0,1.0
11-14-2022,21798,119,0,21798,0.55,0,1.0027140162840977
11-15-2022,21798,119,0,21798,0.55,0,1.0
11-16-2022,21798,119,0,21798,0.55,0,1.0
11-17-2022,21798,119,0,21798,0.55,0,1.0
11-18-2022,21798,119,0,21798,0.55,0,1.0
11-19-2022,21798,119,0,21798,0.55,0,1.0
11-20-2022,21798,119,0,21798,0.55,0,1.0
11-21-2022,21798,119,0,21798,0.55,0,1.0
11-22-2022,21798,119,0,21798,0.55,0,1.0
11-23-2022,21798,119,0,21798,0.55,0,1.0
11-24-2022,22091,119,0,22091,0.54,0,1.0134416001468025
11-25-2022,22091,119,0,22091,0.54,0,1.0
11-26-2022,22091,119,0,22091,0.54,0,1.0
11-27-2022,22091,119,0,22091,0.54,0,1.0
11-28-2022,22167,119,0,22167,0.54,0,1.0034403150604319
11-29-2022,22167,119,0,22167,0.54,0,1.0
11-30-2022,22167,119,0,22167,0.54,0,1.0
12-01-2022,22167,119,0,22167,0.54,0,1.0
12-02-2022,22167,119,0,22167,0.54,0,1.0
12-03-2022,22167,119,0,22167,0.54,0,1.0
12-04-2022,22167,119,0,22167,0.54,0,1.0
12-05-2022,22406,119,0,22406,0.53,0,1.0107817927549962
12-06-2022,22406,119,0,22406,0.53,0,1.0
12-07-2022,22406,119,0,22406,0.53,0,1.0
12-08-2022,22406,119,0,22406,0.53,0,1.0
12-09-2022,22406,119,0,22406,0.53,0,1.0
12-10-2022,22406,119,0,22406,0.53,0,1.0
12-11-2022,22406,119,0,22406,0.53,0,1.0
12-12-2022,22615,120,0,22615,0.53,0,1.009327858609301
12-13-2022,22615,120,0,22615,0.53,0,1.0
12-14-2022,22615,120,0,22615,0.53,0,1.0
12-15-2022,22615,120,0,22615,0.53,0,1.0
12-16-2022,22615,120,0,22615,0.53,0,1.0
12-17-2022,22615,120,0,22615,0.53,0,1.0
12-18-2022,22615,120,0,22615,0.53,0,1.0
12-19-2022,22813,120,0,22813,0.53,0,1.0087552509396418
12-20-2022,22813,120,0,22813,0.53,0,1.0
12-21-2022,22813,120,0,22813,0.53,0,1.0
12-22-2022,22813,120,0,22813,0.53,0,1.0
12-23-2022,22813,120,0,22813,0.53,0,1.0
12-24-2022,22813,120,0,22813,0.53,0,1.0
12-25-2022,22813,120,0,22813,0.53,0,1.0
12-26-2022,22994,120,0,22994,0.52,0,1.0079340726778592
12-27-2022,23008,121,0,23008,0.53,0,1.0006088544837783
12-28-2022,23008,121,0,23008,0.53,0,1.0
12-29-2022,23008,121,0,23008,0.53,0,1.0
12-30-2022,23008,121,0,23008,0.53,0,1.0
12-31-2022,23008,121,0,23008,0.53,0,1.0
01-01-2023,23008,121,0,23008,0.53,0,1.0
01-02-2023,23176,121,0,23176,0.52,0,1.0073018080667593
01-03-2023,23176,121,0,23176,0.52,0,1.0
01-04-2023,23176,121,0,23176,0.52,0,1.0
01-05-2023,23176,121,0,23176,0.52,0,1.0
01-06-2023,23176,121,0,23176,0.52,0,1.0
01-07-2023,23176,121,0,23176,0.52,0,1.0
01-08-2023,23176,121,0,23176,0.52,0,1.0
01-09-2023,23290,121,0,23290,0.52,0,1.004918881601657
01-10-2023,23290,121,0,23290,0.52,0,1.0
01-11-2023,23290,121,0,23290,0.52,0,1.0
01-12-2023,23290,121,0,23290,0.52,0,1.0
01-13-2023,23290,121,0,23290,0.52,0,1.0
01-14-2023,23290,121,0,23290,0.52,0,1.0
01-15-2023,23290,121,0,23290,0.52,0,1.0
01-16-2023,23290,121,0,23290,0.52,0,1.0
01-17-2023,23370,122,0,23370,0.52,0,1.0034349506225848
01-18-2023,23370,122,0,23370,0.52,0,1.0
01-19-2023,23370,122,0,23370,0.52,0,1.0
01-20-2023,23370,122,0,23370,0.52,0,1.0
01-21-2023,23370,122,0,23370,0.52,0,1.0
01-22-2023,23370,122,0,23370,0.52,0,1.0
01-23-2023,23370,122,0,23370,0.52,0,1.0
01-24-2023,23403,122,0,23403,0.52,0,1.0014120667522464
01-25-2023,23403,122,0,23403,0.52,0,1.0
01-26-2023,23403,122,0,23403,0.52,0,1.0
01-27-2023,23403,122,0,23403,0.52,0,1.0
01-28-2023,23403,122,0,23403,0.52,0,1.0
01-29-2023,23403,122,0,23403,0.52,0,1.0
01-30-2023,23427,122,0,23427,0.52,0,1.0010255095500578
01-31-2023,23427,122,0,23427,0.52,0,1.0
02-01-2023,23427,122,0,23427,0.52,0,1.0
02-02-2023,23427,122,0,23427,0.52,0,1.0
02-03-2023,23427,122,0,23427,0.52,0,1.0
02-04-2023,23427,122,0,23427,0.52,0,1.0
02-05-2023,23427,122,0,23427,0.52,0,1.0
02-06-2023,23427,122,0,23427,0.52,0,1.0
02-07-2023,23468,122,0,23468,0.52,0,1.0017501173859222
02-08-2023,23468,122,0,23468,0.52,0,1.0
02-09-2023,23468,122,0,23468,0.52,0,1.0
02-10-2023,23468,122,0,23468,0.52,0,1.0
02-11-2023,23468,122,0,23468,0.52,0,1.0
02-12-2023,23468,122,0,23468,0.52,0,1.0
02-13-2023,23468,122,0,23468,0.52,0,1.0
02-14-2023,23494,122,0,23494,0.52,0,1.0011078915970684
02-15-2023,23494,122,0,23494,0.52,0,1.0
02-16-2023,23494,122,0,23494,0.52,0,1.0
02-17-2023,23521,122,0,23521,0.52,0,1.0011492295905338
02-18-2023,23521,122,0,23521,0.52,0,1.0
02-19-2023,23521,122,0,23521,0.52,0,1.0
02-20-2023,23521,122,0,23521,0.52,0,1.0
02-21-2023,23521,122,0,23521,0.52,0,1.0
02-22-2023,23536,122,0,23536,0.52,0,1.0006377279877556
02-23-2023,23536,122,0,23536,0.52,0,1.0
02-24-2023,23536,122,0,23536,0.52,0,1.0
02-25-2023,23536,122,0,23536,0.52,0,1.0
02-26-2023,23536,122,0,23536,0.52,0,1.0
02-27-2023,23536,122,0,23536,0.52,0,1.0
02-28-2023,23536,122,0,23536,0.52,0,1.0
03-01-2023,23583,122,0,23583,0.52,0,1.00199694085656
03-02-2023,23583,122,0,23583,0.52,0,1.0
03-03-2023,23583,122,0,23583,0.52,0,1.0
03-04-2023,23583,122,0,23583,0.52,0,1.0
03-05-2023,23583,122,0,23583,0.52,0,1.0
03-06-2023,23583,122,0,23583,0.52,0,1.0
03-07-2023,23616,122,0,23616,0.52,0,1.0013993130644956
03-08-2023,23616,122,0,23616,0.52,0,1.0
03-09-2023,23616,122,0,23616,0.52,0,1.0
